Location,Category,Pointing,Declaring,Registering,RegistrationNotValid,Total
DAUGAVPILS,Preschool.All,142,6114,1,14,6271
DAUGAVPILS,Preschool.Males,81,3184,1,7,3273
DAUGAVPILS,Preschool.Females,61,2930,0,7,2998
DAUGAVPILS,School.All,49,9100,0,120,9269
DAUGAVPILS,School.Males,25,4631,0,59,4715
DAUGAVPILS,School.Females,24,4469,0,61,4554
DAUGAVPILS,Children.All,191,15214,1,134,15540
JELGAVA,Preschool.All,68,4924,0,27,5019
JELGAVA,Preschool.Males,34,2505,0,19,2558
JELGAVA,Preschool.Females,34,2419,0,8,2461
JELGAVA,School.All,13,6591,0,155,6759
JELGAVA,School.Males,4,3273,0,79,3356
JELGAVA,School.Females,9,3318,0,76,3403
JELGAVA,Children.All,81,11515,0,182,11778
JĒKABPILS,Preschool.All,40,1538,6,17,1601
JĒKABPILS,Preschool.Males,20,793,1,8,822
JĒKABPILS,Preschool.Females,20,745,5,9,779
JĒKABPILS,School.All,1,2445,193,110,2749
JĒKABPILS,School.Males,0,1213,101,62,1376
JĒKABPILS,School.Females,1,1232,92,48,1373
JĒKABPILS,Children.All,41,3983,199,127,4350
JŪRMALA,Preschool.All,108,3749,0,20,3877
JŪRMALA,Preschool.Males,56,1955,0,16,2027
JŪRMALA,Preschool.Females,52,1794,0,4,1850
JŪRMALA,School.All,45,5698,0,92,5835
JŪRMALA,School.Males,22,2945,0,49,3016
JŪRMALA,School.Females,23,2753,0,43,2819
JŪRMALA,Children.All,153,9447,0,112,9712
LIEPĀJA,Preschool.All,68,5597,7,54,5726
LIEPĀJA,Preschool.Males,42,2867,2,24,2935
LIEPĀJA,Preschool.Females,26,2730,5,30,2791
LIEPĀJA,School.All,33,8421,2,203,8659
LIEPĀJA,School.Males,19,4298,2,101,4420
LIEPĀJA,School.Females,14,4123,0,102,4239
LIEPĀJA,Children.All,101,14018,9,257,14385
RĒZEKNE,Preschool.All,35,1919,0,10,1964
RĒZEKNE,Preschool.Males,15,991,0,7,1013
RĒZEKNE,Preschool.Females,20,928,0,3,951
RĒZEKNE,School.All,21,3215,0,43,3279
RĒZEKNE,School.Males,10,1671,0,18,1699
RĒZEKNE,School.Females,11,1544,0,25,1580
RĒZEKNE,Children.All,56,5134,0,53,5243
RĪGA,Preschool.All,2664,47748,12,220,50644
RĪGA,Preschool.Males,1353,24444,7,116,25920
RĪGA,Preschool.Females,1311,23304,5,104,24724
RĪGA,School.All,759,61871,21,952,63603
RĪGA,School.Males,380,31758,11,515,32664
RĪGA,School.Females,379,30113,10,437,30939
RĪGA,Children.All,3423,109619,33,1172,114247
VALMIERA,Preschool.All,18,1873,0,24,1915
VALMIERA,Preschool.Males,9,973,0,12,994
VALMIERA,Preschool.Females,9,900,0,12,921
VALMIERA,School.All,6,2505,24,52,2587
VALMIERA,School.Males,3,1274,8,26,1311
VALMIERA,School.Females,3,1231,16,26,1276
VALMIERA,Children.All,24,4378,24,76,4502
VENTSPILS,Preschool.All,107,2492,0,23,2622
VENTSPILS,Preschool.Males,59,1283,0,8,1350
VENTSPILS,Preschool.Females,48,1209,0,15,1272
VENTSPILS,School.All,26,3972,0,83,4081
VENTSPILS,School.Males,19,1955,0,43,2017
VENTSPILS,School.Females,7,2017,0,40,2064
VENTSPILS,Children.All,133,6464,0,106,6703
AGLONAS NOVADS,Preschool.All,11,194,0,3,208
AGLONAS NOVADS,Preschool.Males,4,98,0,2,104
AGLONAS NOVADS,Preschool.Females,7,96,0,1,104
AGLONAS NOVADS,School.All,4,386,0,1,391
AGLONAS NOVADS,School.Males,3,194,0,0,197
AGLONAS NOVADS,School.Females,1,192,0,1,194
AGLONAS NOVADS,Children.All,15,580,0,4,599
AIZKRAUKLES NOVADS,Preschool.All,26,520,0,4,550
AIZKRAUKLES NOVADS,Preschool.Males,16,291,0,1,308
AIZKRAUKLES NOVADS,Preschool.Females,10,229,0,3,242
AIZKRAUKLES NOVADS,School.All,15,883,1,9,908
AIZKRAUKLES NOVADS,School.Males,6,467,0,5,478
AIZKRAUKLES NOVADS,School.Females,9,416,1,4,430
AIZKRAUKLES NOVADS,Children.All,41,1403,1,13,1458
AIZPUTES NOVADS,Preschool.All,9,600,0,1,610
AIZPUTES NOVADS,Preschool.Males,5,309,0,1,315
AIZPUTES NOVADS,Preschool.Females,4,291,0,0,295
AIZPUTES NOVADS,School.All,11,1080,1,9,1101
AIZPUTES NOVADS,School.Males,3,576,0,6,585
AIZPUTES NOVADS,School.Females,8,504,1,3,516
AIZPUTES NOVADS,Children.All,20,1680,1,10,1711
AKNĪSTES NOVADS,Preschool.All,2,145,0,0,147
AKNĪSTES NOVADS,Preschool.Males,0,80,0,0,80
AKNĪSTES NOVADS,Preschool.Females,2,65,0,0,67
AKNĪSTES NOVADS,School.All,0,256,1,0,257
AKNĪSTES NOVADS,School.Males,0,129,0,0,129
AKNĪSTES NOVADS,School.Females,0,127,1,0,128
AKNĪSTES NOVADS,Children.All,2,401,1,0,404
ALOJAS NOVADS,Preschool.All,17,319,0,0,336
ALOJAS NOVADS,Preschool.Males,13,169,0,0,182
ALOJAS NOVADS,Preschool.Females,4,150,0,0,154
ALOJAS NOVADS,School.All,22,544,0,0,566
ALOJAS NOVADS,School.Males,12,267,0,0,279
ALOJAS NOVADS,School.Females,10,277,0,0,287
ALOJAS NOVADS,Children.All,39,863,0,0,902
ALSUNGAS NOVADS,Preschool.All,4,80,0,0,84
ALSUNGAS NOVADS,Preschool.Males,2,44,0,0,46
ALSUNGAS NOVADS,Preschool.Females,2,36,0,0,38
ALSUNGAS NOVADS,School.All,0,165,2,1,168
ALSUNGAS NOVADS,School.Males,0,73,1,1,75
ALSUNGAS NOVADS,School.Females,0,92,1,0,93
ALSUNGAS NOVADS,Children.All,4,245,2,1,252
ALŪKSNES NOVADS,Preschool.All,48,1014,2,2,1066
ALŪKSNES NOVADS,Preschool.Males,26,516,0,2,544
ALŪKSNES NOVADS,Preschool.Females,22,498,2,0,522
ALŪKSNES NOVADS,School.All,2,1795,4,8,1809
ALŪKSNES NOVADS,School.Males,2,888,3,3,896
ALŪKSNES NOVADS,School.Females,0,907,1,5,913
ALŪKSNES NOVADS,Children.All,50,2809,6,10,2875
AMATAS NOVADS,Preschool.All,26,346,0,0,372
AMATAS NOVADS,Preschool.Males,10,176,0,0,186
AMATAS NOVADS,Preschool.Females,16,170,0,0,186
AMATAS NOVADS,School.All,9,677,0,1,687
AMATAS NOVADS,School.Males,5,353,0,1,359
AMATAS NOVADS,School.Females,4,324,0,0,328
AMATAS NOVADS,Children.All,35,1023,0,1,1059
APES NOVADS,Preschool.All,4,232,0,0,236
APES NOVADS,Preschool.Males,2,120,0,0,122
APES NOVADS,Preschool.Females,2,112,0,0,114
APES NOVADS,School.All,0,398,0,0,398
APES NOVADS,School.Males,0,204,0,0,204
APES NOVADS,School.Females,0,194,0,0,194
APES NOVADS,Children.All,4,630,0,0,634
AUCES NOVADS,Preschool.All,12,417,0,2,431
AUCES NOVADS,Preschool.Males,8,224,0,2,234
AUCES NOVADS,Preschool.Females,4,193,0,0,197
AUCES NOVADS,School.All,2,820,0,9,831
AUCES NOVADS,School.Males,1,414,0,5,420
AUCES NOVADS,School.Females,1,406,0,4,411
AUCES NOVADS,Children.All,14,1237,0,11,1262
ĀDAŽU NOVADS,Preschool.All,16,1127,0,1,1144
ĀDAŽU NOVADS,Preschool.Males,6,579,0,1,586
ĀDAŽU NOVADS,Preschool.Females,10,548,0,0,558
ĀDAŽU NOVADS,School.All,7,1405,0,22,1434
ĀDAŽU NOVADS,School.Males,2,716,0,10,728
ĀDAŽU NOVADS,School.Females,5,689,0,12,706
ĀDAŽU NOVADS,Children.All,23,2532,0,23,2578
BABĪTES NOVADS,Preschool.All,10,1046,0,2,1058
BABĪTES NOVADS,Preschool.Males,5,515,0,1,521
BABĪTES NOVADS,Preschool.Females,5,531,0,1,537
BABĪTES NOVADS,School.All,6,1383,0,8,1397
BABĪTES NOVADS,School.Males,0,699,0,3,702
BABĪTES NOVADS,School.Females,6,684,0,5,695
BABĪTES NOVADS,Children.All,16,2429,0,10,2455
BALDONES NOVADS,Preschool.All,2,434,0,1,437
BALDONES NOVADS,Preschool.Males,1,227,0,1,229
BALDONES NOVADS,Preschool.Females,1,207,0,0,208
BALDONES NOVADS,School.All,6,728,0,6,740
BALDONES NOVADS,School.Males,2,382,0,4,388
BALDONES NOVADS,School.Females,4,346,0,2,352
BALDONES NOVADS,Children.All,8,1162,0,7,1177
BALTINAVAS NOVADS,Preschool.All,0,51,0,0,51
BALTINAVAS NOVADS,Preschool.Males,0,27,0,0,27
BALTINAVAS NOVADS,Preschool.Females,0,24,0,0,24
BALTINAVAS NOVADS,School.All,1,113,0,0,114
BALTINAVAS NOVADS,School.Males,0,55,0,0,55
BALTINAVAS NOVADS,School.Females,1,58,0,0,59
BALTINAVAS NOVADS,Children.All,1,164,0,0,165
BALVU NOVADS,Preschool.All,28,768,1,4,801
BALVU NOVADS,Preschool.Males,18,410,1,1,430
BALVU NOVADS,Preschool.Females,10,358,0,3,371
BALVU NOVADS,School.All,7,1422,0,9,1438
BALVU NOVADS,School.Males,3,746,0,7,756
BALVU NOVADS,School.Females,4,676,0,2,682
BALVU NOVADS,Children.All,35,2190,1,13,2239
BAUSKAS NOVADS,Preschool.All,49,1672,2,7,1730
BAUSKAS NOVADS,Preschool.Males,26,861,1,6,894
BAUSKAS NOVADS,Preschool.Females,23,811,1,1,836
BAUSKAS NOVADS,School.All,9,2769,0,13,2791
BAUSKAS NOVADS,School.Males,5,1399,0,8,1412
BAUSKAS NOVADS,School.Females,4,1370,0,5,1379
BAUSKAS NOVADS,Children.All,58,4441,2,20,4521
BEVERĪNAS NOVADS,Preschool.All,8,221,2,1,232
BEVERĪNAS NOVADS,Preschool.Males,4,118,1,0,123
BEVERĪNAS NOVADS,Preschool.Females,4,103,1,1,109
BEVERĪNAS NOVADS,School.All,2,329,0,1,332
BEVERĪNAS NOVADS,School.Males,0,171,0,1,172
BEVERĪNAS NOVADS,School.Females,2,158,0,0,160
BEVERĪNAS NOVADS,Children.All,10,550,2,2,564
BROCĒNU NOVADS,Preschool.All,1,392,0,3,396
BROCĒNU NOVADS,Preschool.Males,1,198,0,1,200
BROCĒNU NOVADS,Preschool.Females,0,194,0,2,196
BROCĒNU NOVADS,School.All,10,712,0,2,724
BROCĒNU NOVADS,School.Males,5,367,0,2,374
BROCĒNU NOVADS,School.Females,5,345,0,0,350
BROCĒNU NOVADS,Children.All,11,1104,0,5,1120
BURTNIEKU NOVADS,Preschool.All,2,549,0,0,551
BURTNIEKU NOVADS,Preschool.Males,0,277,0,0,277
BURTNIEKU NOVADS,Preschool.Females,2,272,0,0,274
BURTNIEKU NOVADS,School.All,4,866,0,1,871
BURTNIEKU NOVADS,School.Males,3,443,0,1,447
BURTNIEKU NOVADS,School.Females,1,423,0,0,424
BURTNIEKU NOVADS,Children.All,6,1415,0,1,1422
CARNIKAVAS NOVADS,Preschool.All,9,520,1,0,530
CARNIKAVAS NOVADS,Preschool.Males,7,262,0,0,269
CARNIKAVAS NOVADS,Preschool.Females,2,258,1,0,261
CARNIKAVAS NOVADS,School.All,7,646,0,9,662
CARNIKAVAS NOVADS,School.Males,5,348,0,5,358
CARNIKAVAS NOVADS,School.Females,2,298,0,4,304
CARNIKAVAS NOVADS,Children.All,16,1166,1,9,1192
CESVAINES NOVADS,Preschool.All,1,124,0,0,125
CESVAINES NOVADS,Preschool.Males,1,70,0,0,71
CESVAINES NOVADS,Preschool.Females,0,54,0,0,54
CESVAINES NOVADS,School.All,0,302,3,0,305
CESVAINES NOVADS,School.Males,0,168,2,0,170
CESVAINES NOVADS,School.Females,0,134,1,0,135
CESVAINES NOVADS,Children.All,1,426,3,0,430
CĒSU NOVADS,Preschool.All,27,1297,0,6,1330
CĒSU NOVADS,Preschool.Males,16,670,0,1,687
CĒSU NOVADS,Preschool.Females,11,627,0,5,643
CĒSU NOVADS,School.All,7,1847,0,29,1883
CĒSU NOVADS,School.Males,3,929,0,16,948
CĒSU NOVADS,School.Females,4,918,0,13,935
CĒSU NOVADS,Children.All,34,3144,0,35,3213
CIBLAS NOVADS,Preschool.All,6,153,0,0,159
CIBLAS NOVADS,Preschool.Males,3,71,0,0,74
CIBLAS NOVADS,Preschool.Females,3,82,0,0,85
CIBLAS NOVADS,School.All,2,262,1,0,265
CIBLAS NOVADS,School.Males,1,125,1,0,127
CIBLAS NOVADS,School.Females,1,137,0,0,138
CIBLAS NOVADS,Children.All,8,415,1,0,424
DAGDAS NOVADS,Preschool.All,11,384,0,0,395
DAGDAS NOVADS,Preschool.Males,6,198,0,0,204
DAGDAS NOVADS,Preschool.Females,5,186,0,0,191
DAGDAS NOVADS,School.All,15,838,1,0,854
DAGDAS NOVADS,School.Males,6,434,1,0,441
DAGDAS NOVADS,School.Females,9,404,0,0,413
DAGDAS NOVADS,Children.All,26,1222,1,0,1249
DAUGAVPILS NOVADS,Preschool.All,60,1251,1,1,1313
DAUGAVPILS NOVADS,Preschool.Males,29,644,0,0,673
DAUGAVPILS NOVADS,Preschool.Females,31,607,1,1,640
DAUGAVPILS NOVADS,School.All,11,2267,2,19,2299
DAUGAVPILS NOVADS,School.Males,5,1166,2,9,1182
DAUGAVPILS NOVADS,School.Females,6,1101,0,10,1117
DAUGAVPILS NOVADS,Children.All,71,3518,3,20,3612
DOBELES NOVADS,Preschool.All,13,1432,1,6,1452
DOBELES NOVADS,Preschool.Males,5,738,1,3,747
DOBELES NOVADS,Preschool.Females,8,694,0,3,705
DOBELES NOVADS,School.All,8,2444,0,25,2477
DOBELES NOVADS,School.Males,5,1237,0,12,1254
DOBELES NOVADS,School.Females,3,1207,0,13,1223
DOBELES NOVADS,Children.All,21,3876,1,31,3929
DUNDAGAS NOVADS,Preschool.All,6,255,0,0,261
DUNDAGAS NOVADS,Preschool.Males,4,132,0,0,136
DUNDAGAS NOVADS,Preschool.Females,2,123,0,0,125
DUNDAGAS NOVADS,School.All,21,427,0,1,449
DUNDAGAS NOVADS,School.Males,10,232,0,0,242
DUNDAGAS NOVADS,School.Females,11,195,0,1,207
DUNDAGAS NOVADS,Children.All,27,682,0,1,710
DURBES NOVADS,Preschool.All,0,175,0,0,175
DURBES NOVADS,Preschool.Males,0,86,0,0,86
DURBES NOVADS,Preschool.Females,0,89,0,0,89
DURBES NOVADS,School.All,0,315,0,4,319
DURBES NOVADS,School.Males,0,159,0,1,160
DURBES NOVADS,School.Females,0,156,0,3,159
DURBES NOVADS,Children.All,0,490,0,4,494
ENGURES NOVADS,Preschool.All,12,401,0,0,413
ENGURES NOVADS,Preschool.Males,7,205,0,0,212
ENGURES NOVADS,Preschool.Females,5,196,0,0,201
ENGURES NOVADS,School.All,3,728,0,1,732
ENGURES NOVADS,School.Males,2,389,0,0,391
ENGURES NOVADS,School.Females,1,339,0,1,341
ENGURES NOVADS,Children.All,15,1129,0,1,1145
ĒRGĻU NOVADS,Preschool.All,6,165,0,0,171
ĒRGĻU NOVADS,Preschool.Males,3,80,0,0,83
ĒRGĻU NOVADS,Preschool.Females,3,85,0,0,88
ĒRGĻU NOVADS,School.All,2,304,0,0,306
ĒRGĻU NOVADS,School.Males,0,141,0,0,141
ĒRGĻU NOVADS,School.Females,2,163,0,0,165
ĒRGĻU NOVADS,Children.All,8,469,0,0,477
GARKALNES NOVADS,Preschool.All,19,693,0,0,712
GARKALNES NOVADS,Preschool.Males,8,357,0,0,365
GARKALNES NOVADS,Preschool.Females,11,336,0,0,347
GARKALNES NOVADS,School.All,13,1057,0,5,1075
GARKALNES NOVADS,School.Males,7,555,0,4,566
GARKALNES NOVADS,School.Females,6,502,0,1,509
GARKALNES NOVADS,Children.All,32,1750,0,5,1787
GROBIŅAS NOVADS,Preschool.All,7,623,0,1,631
GROBIŅAS NOVADS,Preschool.Males,3,314,0,1,318
GROBIŅAS NOVADS,Preschool.Females,4,309,0,0,313
GROBIŅAS NOVADS,School.All,4,1086,0,8,1098
GROBIŅAS NOVADS,School.Males,3,567,0,2,572
GROBIŅAS NOVADS,School.Females,1,519,0,6,526
GROBIŅAS NOVADS,Children.All,11,1709,0,9,1729
GULBENES NOVADS,Preschool.All,25,1346,4,4,1379
GULBENES NOVADS,Preschool.Males,13,679,0,2,694
GULBENES NOVADS,Preschool.Females,12,667,4,2,685
GULBENES NOVADS,School.All,11,2411,1,13,2436
GULBENES NOVADS,School.Males,7,1280,0,6,1293
GULBENES NOVADS,School.Females,4,1131,1,7,1143
GULBENES NOVADS,Children.All,36,3757,5,17,3815
IECAVAS NOVADS,Preschool.All,8,685,1,5,699
IECAVAS NOVADS,Preschool.Males,3,344,1,3,351
IECAVAS NOVADS,Preschool.Females,5,341,0,2,348
IECAVAS NOVADS,School.All,13,1080,0,13,1106
IECAVAS NOVADS,School.Males,7,562,0,6,575
IECAVAS NOVADS,School.Females,6,518,0,7,531
IECAVAS NOVADS,Children.All,21,1765,1,18,1805
IKŠĶILES NOVADS,Preschool.All,4,909,0,3,916
IKŠĶILES NOVADS,Preschool.Males,1,475,0,3,479
IKŠĶILES NOVADS,Preschool.Females,3,434,0,0,437
IKŠĶILES NOVADS,School.All,1,1181,0,6,1188
IKŠĶILES NOVADS,School.Males,0,576,0,4,580
IKŠĶILES NOVADS,School.Females,1,605,0,2,608
IKŠĶILES NOVADS,Children.All,5,2090,0,9,2104
ILŪKSTES NOVADS,Preschool.All,4,404,0,1,409
ILŪKSTES NOVADS,Preschool.Males,2,199,0,0,201
ILŪKSTES NOVADS,Preschool.Females,2,205,0,1,208
ILŪKSTES NOVADS,School.All,1,794,0,4,799
ILŪKSTES NOVADS,School.Males,1,390,0,3,394
ILŪKSTES NOVADS,School.Females,0,404,0,1,405
ILŪKSTES NOVADS,Children.All,5,1198,0,5,1208
INČUKALNA NOVADS,Preschool.All,15,577,0,3,595
INČUKALNA NOVADS,Preschool.Males,11,301,0,3,315
INČUKALNA NOVADS,Preschool.Females,4,276,0,0,280
INČUKALNA NOVADS,School.All,11,832,0,13,856
INČUKALNA NOVADS,School.Males,3,438,0,7,448
INČUKALNA NOVADS,School.Females,8,394,0,6,408
INČUKALNA NOVADS,Children.All,26,1409,0,16,1451
JAUNJELGAVAS NOVADS,Preschool.All,13,333,0,2,348
JAUNJELGAVAS NOVADS,Preschool.Males,8,170,0,1,179
JAUNJELGAVAS NOVADS,Preschool.Females,5,163,0,1,169
JAUNJELGAVAS NOVADS,School.All,13,608,1,4,626
JAUNJELGAVAS NOVADS,School.Males,10,305,1,2,318
JAUNJELGAVAS NOVADS,School.Females,3,303,0,2,308
JAUNJELGAVAS NOVADS,Children.All,26,941,1,6,974
JAUNPIEBALGAS NOVADS,Preschool.All,11,131,0,0,142
JAUNPIEBALGAS NOVADS,Preschool.Males,2,59,0,0,61
JAUNPIEBALGAS NOVADS,Preschool.Females,9,72,0,0,81
JAUNPIEBALGAS NOVADS,School.All,3,258,2,3,266
JAUNPIEBALGAS NOVADS,School.Males,0,113,1,1,115
JAUNPIEBALGAS NOVADS,School.Females,3,145,1,2,151
JAUNPIEBALGAS NOVADS,Children.All,14,389,2,3,408
JAUNPILS NOVADS,Preschool.All,10,165,0,0,175
JAUNPILS NOVADS,Preschool.Males,4,82,0,0,86
JAUNPILS NOVADS,Preschool.Females,6,83,0,0,89
JAUNPILS NOVADS,School.All,0,276,0,0,276
JAUNPILS NOVADS,School.Males,0,132,0,0,132
JAUNPILS NOVADS,School.Females,0,144,0,0,144
JAUNPILS NOVADS,Children.All,10,441,0,0,451
JELGAVAS NOVADS,Preschool.All,19,1430,0,5,1454
JELGAVAS NOVADS,Preschool.Males,15,728,0,3,746
JELGAVAS NOVADS,Preschool.Females,4,702,0,2,708
JELGAVAS NOVADS,School.All,28,2583,1,15,2627
JELGAVAS NOVADS,School.Males,14,1324,0,8,1346
JELGAVAS NOVADS,School.Females,14,1259,1,7,1281
JELGAVAS NOVADS,Children.All,47,4013,1,20,4081
JĒKABPILS NOVADS,Preschool.All,6,256,1,4,267
JĒKABPILS NOVADS,Preschool.Males,2,107,1,3,113
JĒKABPILS NOVADS,Preschool.Females,4,149,0,1,154
JĒKABPILS NOVADS,School.All,2,475,0,0,477
JĒKABPILS NOVADS,School.Males,1,247,0,0,248
JĒKABPILS NOVADS,School.Females,1,228,0,0,229
JĒKABPILS NOVADS,Children.All,8,731,1,4,744
KANDAVAS NOVADS,Preschool.All,6,549,0,6,561
KANDAVAS NOVADS,Preschool.Males,2,294,0,3,299
KANDAVAS NOVADS,Preschool.Females,4,255,0,3,262
KANDAVAS NOVADS,School.All,9,1080,0,13,1102
KANDAVAS NOVADS,School.Males,3,554,0,5,562
KANDAVAS NOVADS,School.Females,6,526,0,8,540
KANDAVAS NOVADS,Children.All,15,1629,0,19,1663
KĀRSAVAS NOVADS,Preschool.All,3,318,0,0,321
KĀRSAVAS NOVADS,Preschool.Males,3,140,0,0,143
KĀRSAVAS NOVADS,Preschool.Females,0,178,0,0,178
KĀRSAVAS NOVADS,School.All,5,633,0,0,638
KĀRSAVAS NOVADS,School.Males,3,339,0,0,342
KĀRSAVAS NOVADS,School.Females,2,294,0,0,296
KĀRSAVAS NOVADS,Children.All,8,951,0,0,959
KOCĒNU NOVADS,Preschool.All,18,406,0,1,425
KOCĒNU NOVADS,Preschool.Males,11,223,0,1,235
KOCĒNU NOVADS,Preschool.Females,7,183,0,0,190
KOCĒNU NOVADS,School.All,16,661,3,8,688
KOCĒNU NOVADS,School.Males,9,320,2,5,336
KOCĒNU NOVADS,School.Females,7,341,1,3,352
KOCĒNU NOVADS,Children.All,34,1067,3,9,1113
KOKNESES NOVADS,Preschool.All,1,350,1,0,352
KOKNESES NOVADS,Preschool.Males,0,167,0,0,167
KOKNESES NOVADS,Preschool.Females,1,183,1,0,185
KOKNESES NOVADS,School.All,3,649,0,6,658
KOKNESES NOVADS,School.Males,2,340,0,4,346
KOKNESES NOVADS,School.Females,1,309,0,2,312
KOKNESES NOVADS,Children.All,4,999,1,6,1010
KRĀSLAVAS NOVADS,Preschool.All,74,742,13,6,835
KRĀSLAVAS NOVADS,Preschool.Males,35,336,5,3,379
KRĀSLAVAS NOVADS,Preschool.Females,39,406,8,3,456
KRĀSLAVAS NOVADS,School.All,17,1670,1,22,1710
KRĀSLAVAS NOVADS,School.Males,8,864,1,10,883
KRĀSLAVAS NOVADS,School.Females,9,806,0,12,827
KRĀSLAVAS NOVADS,Children.All,91,2412,14,28,2545
KRIMULDAS NOVADS,Preschool.All,3,394,0,0,397
KRIMULDAS NOVADS,Preschool.Males,3,212,0,0,215
KRIMULDAS NOVADS,Preschool.Females,0,182,0,0,182
KRIMULDAS NOVADS,School.All,2,535,0,0,537
KRIMULDAS NOVADS,School.Males,0,275,0,0,275
KRIMULDAS NOVADS,School.Females,2,260,0,0,262
KRIMULDAS NOVADS,Children.All,5,929,0,0,934
KRUSTPILS NOVADS,Preschool.All,10,406,0,0,416
KRUSTPILS NOVADS,Preschool.Males,3,213,0,0,216
KRUSTPILS NOVADS,Preschool.Females,7,193,0,0,200
KRUSTPILS NOVADS,School.All,0,664,0,1,665
KRUSTPILS NOVADS,School.Males,0,344,0,0,344
KRUSTPILS NOVADS,School.Females,0,320,0,1,321
KRUSTPILS NOVADS,Children.All,10,1070,0,1,1081
KULDĪGAS NOVADS,Preschool.All,32,1666,0,9,1707
KULDĪGAS NOVADS,Preschool.Males,21,859,0,1,881
KULDĪGAS NOVADS,Preschool.Females,11,807,0,8,826
KULDĪGAS NOVADS,School.All,7,2958,0,45,3010
KULDĪGAS NOVADS,School.Males,5,1498,0,25,1528
KULDĪGAS NOVADS,School.Females,2,1460,0,20,1482
KULDĪGAS NOVADS,Children.All,39,4624,0,54,4717
ĶEGUMA NOVADS,Preschool.All,9,360,0,3,372
ĶEGUMA NOVADS,Preschool.Males,4,183,0,1,188
ĶEGUMA NOVADS,Preschool.Females,5,177,0,2,184
ĶEGUMA NOVADS,School.All,3,563,0,6,572
ĶEGUMA NOVADS,School.Males,1,293,0,3,297
ĶEGUMA NOVADS,School.Females,2,270,0,3,275
ĶEGUMA NOVADS,Children.All,12,923,0,9,944
ĶEKAVAS NOVADS,Preschool.All,52,2522,0,4,2578
ĶEKAVAS NOVADS,Preschool.Males,29,1293,0,2,1324
ĶEKAVAS NOVADS,Preschool.Females,23,1229,0,2,1254
ĶEKAVAS NOVADS,School.All,41,2563,0,20,2624
ĶEKAVAS NOVADS,School.Males,18,1314,0,11,1343
ĶEKAVAS NOVADS,School.Females,23,1249,0,9,1281
ĶEKAVAS NOVADS,Children.All,93,5085,0,24,5202
LIELVĀRDES NOVADS,Preschool.All,7,734,0,6,747
LIELVĀRDES NOVADS,Preschool.Males,2,364,0,2,368
LIELVĀRDES NOVADS,Preschool.Females,5,370,0,4,379
LIELVĀRDES NOVADS,School.All,1,1169,0,17,1187
LIELVĀRDES NOVADS,School.Males,1,589,0,6,596
LIELVĀRDES NOVADS,School.Females,0,580,0,11,591
LIELVĀRDES NOVADS,Children.All,8,1903,0,23,1934
LIMBAŽU NOVADS,Preschool.All,34,1082,1,7,1124
LIMBAŽU NOVADS,Preschool.Males,23,548,0,2,573
LIMBAŽU NOVADS,Preschool.Females,11,534,1,5,551
LIMBAŽU NOVADS,School.All,13,1802,1,9,1825
LIMBAŽU NOVADS,School.Males,8,935,0,4,947
LIMBAŽU NOVADS,School.Females,5,867,1,5,878
LIMBAŽU NOVADS,Children.All,47,2884,2,16,2949
LĪGATNES NOVADS,Preschool.All,2,222,0,1,225
LĪGATNES NOVADS,Preschool.Males,1,118,0,1,120
LĪGATNES NOVADS,Preschool.Females,1,104,0,0,105
LĪGATNES NOVADS,School.All,2,334,0,2,338
LĪGATNES NOVADS,School.Males,0,165,0,1,166
LĪGATNES NOVADS,School.Females,2,169,0,1,172
LĪGATNES NOVADS,Children.All,4,556,0,3,563
LĪVĀNU NOVADS,Preschool.All,11,752,1,1,765
LĪVĀNU NOVADS,Preschool.Males,6,387,0,0,393
LĪVĀNU NOVADS,Preschool.Females,5,365,1,1,372
LĪVĀNU NOVADS,School.All,4,1313,0,5,1322
LĪVĀNU NOVADS,School.Males,2,639,0,3,644
LĪVĀNU NOVADS,School.Females,2,674,0,2,678
LĪVĀNU NOVADS,Children.All,15,2065,1,6,2087
LUBĀNAS NOVADS,Preschool.All,1,132,0,0,133
LUBĀNAS NOVADS,Preschool.Males,0,71,0,0,71
LUBĀNAS NOVADS,Preschool.Females,1,61,0,0,62
LUBĀNAS NOVADS,School.All,0,250,0,0,250
LUBĀNAS NOVADS,School.Males,0,113,0,0,113
LUBĀNAS NOVADS,School.Females,0,137,0,0,137
LUBĀNAS NOVADS,Children.All,1,382,0,0,383
LUDZAS NOVADS,Preschool.All,8,706,1,2,717
LUDZAS NOVADS,Preschool.Males,2,353,0,1,356
LUDZAS NOVADS,Preschool.Females,6,353,1,1,361
LUDZAS NOVADS,School.All,10,1343,0,15,1368
LUDZAS NOVADS,School.Males,4,686,0,6,696
LUDZAS NOVADS,School.Females,6,657,0,9,672
LUDZAS NOVADS,Children.All,18,2049,1,17,2085
MADONAS NOVADS,Preschool.All,130,1403,0,9,1542
MADONAS NOVADS,Preschool.Males,73,707,0,6,786
MADONAS NOVADS,Preschool.Females,57,696,0,3,756
MADONAS NOVADS,School.All,41,2528,0,23,2592
MADONAS NOVADS,School.Males,19,1316,0,13,1348
MADONAS NOVADS,School.Females,22,1212,0,10,1244
MADONAS NOVADS,Children.All,171,3931,0,32,4134
MAZSALACAS NOVADS,Preschool.All,5,187,0,0,192
MAZSALACAS NOVADS,Preschool.Males,4,87,0,0,91
MAZSALACAS NOVADS,Preschool.Females,1,100,0,0,101
MAZSALACAS NOVADS,School.All,4,327,4,3,338
MAZSALACAS NOVADS,School.Males,3,170,0,3,176
MAZSALACAS NOVADS,School.Females,1,157,4,0,162
MAZSALACAS NOVADS,Children.All,9,514,4,3,530
MĀLPILS NOVADS,Preschool.All,1,245,0,0,246
MĀLPILS NOVADS,Preschool.Males,0,128,0,0,128
MĀLPILS NOVADS,Preschool.Females,1,117,0,0,118
MĀLPILS NOVADS,School.All,1,429,0,0,430
MĀLPILS NOVADS,School.Males,0,238,0,0,238
MĀLPILS NOVADS,School.Females,1,191,0,0,192
MĀLPILS NOVADS,Children.All,2,674,0,0,676
MĀRUPES NOVADS,Preschool.All,19,2428,2,4,2453
MĀRUPES NOVADS,Preschool.Males,12,1243,2,2,1259
MĀRUPES NOVADS,Preschool.Females,7,1185,0,2,1194
MĀRUPES NOVADS,School.All,2,2381,2,13,2398
MĀRUPES NOVADS,School.Males,0,1228,2,5,1235
MĀRUPES NOVADS,School.Females,2,1153,0,8,1163
MĀRUPES NOVADS,Children.All,21,4809,4,17,4851
MĒRSRAGA NOVADS,Preschool.All,4,79,0,0,83
MĒRSRAGA NOVADS,Preschool.Males,3,39,0,0,42
MĒRSRAGA NOVADS,Preschool.Females,1,40,0,0,41
MĒRSRAGA NOVADS,School.All,5,171,0,1,177
MĒRSRAGA NOVADS,School.Males,1,88,0,1,90
MĒRSRAGA NOVADS,School.Females,4,83,0,0,87
MĒRSRAGA NOVADS,Children.All,9,250,0,1,260
NAUKŠĒNU NOVADS,Preschool.All,4,111,0,0,115
NAUKŠĒNU NOVADS,Preschool.Males,1,57,0,0,58
NAUKŠĒNU NOVADS,Preschool.Females,3,54,0,0,57
NAUKŠĒNU NOVADS,School.All,0,220,0,2,222
NAUKŠĒNU NOVADS,School.Males,0,116,0,1,117
NAUKŠĒNU NOVADS,School.Females,0,104,0,1,105
NAUKŠĒNU NOVADS,Children.All,4,331,0,2,337
NERETAS NOVADS,Preschool.All,6,195,0,0,201
NERETAS NOVADS,Preschool.Males,5,97,0,0,102
NERETAS NOVADS,Preschool.Females,1,98,0,0,99
NERETAS NOVADS,School.All,1,343,0,3,347
NERETAS NOVADS,School.Males,0,192,0,2,194
NERETAS NOVADS,School.Females,1,151,0,1,153
NERETAS NOVADS,Children.All,7,538,0,3,548
NĪCAS NOVADS,Preschool.All,0,186,0,0,186
NĪCAS NOVADS,Preschool.Males,0,104,0,0,104
NĪCAS NOVADS,Preschool.Females,0,82,0,0,82
NĪCAS NOVADS,School.All,0,349,0,3,352
NĪCAS NOVADS,School.Males,0,177,0,2,179
NĪCAS NOVADS,School.Females,0,172,0,1,173
NĪCAS NOVADS,Children.All,0,535,0,3,538
OGRES NOVADS,Preschool.All,47,2646,0,10,2703
OGRES NOVADS,Preschool.Males,25,1326,0,4,1355
OGRES NOVADS,Preschool.Females,22,1320,0,6,1348
OGRES NOVADS,School.All,22,3833,0,56,3911
OGRES NOVADS,School.Males,10,1922,0,42,1974
OGRES NOVADS,School.Females,12,1911,0,14,1937
OGRES NOVADS,Children.All,69,6479,0,66,6614
OLAINES NOVADS,Preschool.All,15,1448,1,6,1470
OLAINES NOVADS,Preschool.Males,8,708,0,3,719
OLAINES NOVADS,Preschool.Females,7,740,1,3,751
OLAINES NOVADS,School.All,2,2117,0,38,2157
OLAINES NOVADS,School.Males,1,1062,0,18,1081
OLAINES NOVADS,School.Females,1,1055,0,20,1076
OLAINES NOVADS,Children.All,17,3565,1,44,3627
OZOLNIEKU NOVADS,Preschool.All,21,985,0,2,1008
OZOLNIEKU NOVADS,Preschool.Males,11,485,0,0,496
OZOLNIEKU NOVADS,Preschool.Females,10,500,0,2,512
OZOLNIEKU NOVADS,School.All,8,1194,0,12,1214
OZOLNIEKU NOVADS,School.Males,2,593,0,3,598
OZOLNIEKU NOVADS,School.Females,6,601,0,9,616
OZOLNIEKU NOVADS,Children.All,29,2179,0,14,2222
PĀRGAUJAS NOVADS,Preschool.All,18,237,0,0,255
PĀRGAUJAS NOVADS,Preschool.Males,11,135,0,0,146
PĀRGAUJAS NOVADS,Preschool.Females,7,102,0,0,109
PĀRGAUJAS NOVADS,School.All,3,427,0,0,430
PĀRGAUJAS NOVADS,School.Males,2,214,0,0,216
PĀRGAUJAS NOVADS,School.Females,1,213,0,0,214
PĀRGAUJAS NOVADS,Children.All,21,664,0,0,685
PĀVILOSTAS NOVADS,Preschool.All,4,164,0,0,168
PĀVILOSTAS NOVADS,Preschool.Males,3,93,0,0,96
PĀVILOSTAS NOVADS,Preschool.Females,1,71,0,0,72
PĀVILOSTAS NOVADS,School.All,1,273,0,0,274
PĀVILOSTAS NOVADS,School.Males,0,129,0,0,129
PĀVILOSTAS NOVADS,School.Females,1,144,0,0,145
PĀVILOSTAS NOVADS,Children.All,5,437,0,0,442
PĻAVIŅU NOVADS,Preschool.All,2,326,1,2,331
PĻAVIŅU NOVADS,Preschool.Males,0,163,1,2,166
PĻAVIŅU NOVADS,Preschool.Females,2,163,0,0,165
PĻAVIŅU NOVADS,School.All,0,582,1,2,585
PĻAVIŅU NOVADS,School.Males,0,281,1,1,283
PĻAVIŅU NOVADS,School.Females,0,301,0,1,302
PĻAVIŅU NOVADS,Children.All,2,908,2,4,916
PREIĻU NOVADS,Preschool.All,13,641,0,3,657
PREIĻU NOVADS,Preschool.Males,6,322,0,3,331
PREIĻU NOVADS,Preschool.Females,7,319,0,0,326
PREIĻU NOVADS,School.All,0,962,0,10,972
PREIĻU NOVADS,School.Males,0,476,0,7,483
PREIĻU NOVADS,School.Females,0,486,0,3,489
PREIĻU NOVADS,Children.All,13,1603,0,13,1629
PRIEKULES NOVADS,Preschool.All,7,368,0,3,378
PRIEKULES NOVADS,Preschool.Males,4,185,0,2,191
PRIEKULES NOVADS,Preschool.Females,3,183,0,1,187
PRIEKULES NOVADS,School.All,0,677,0,8,685
PRIEKULES NOVADS,School.Males,0,338,0,2,340
PRIEKULES NOVADS,School.Females,0,339,0,6,345
PRIEKULES NOVADS,Children.All,7,1045,0,11,1063
PRIEKUĻU NOVADS,Preschool.All,12,484,0,2,498
PRIEKUĻU NOVADS,Preschool.Males,7,248,0,2,257
PRIEKUĻU NOVADS,Preschool.Females,5,236,0,0,241
PRIEKUĻU NOVADS,School.All,4,909,1,8,922
PRIEKUĻU NOVADS,School.Males,2,465,1,4,472
PRIEKUĻU NOVADS,School.Females,2,444,0,4,450
PRIEKUĻU NOVADS,Children.All,16,1393,1,10,1420
RAUNAS NOVADS,Preschool.All,51,145,0,2,198
RAUNAS NOVADS,Preschool.Males,21,69,0,2,92
RAUNAS NOVADS,Preschool.Females,30,76,0,0,106
RAUNAS NOVADS,School.All,12,354,0,1,367
RAUNAS NOVADS,School.Males,5,182,0,1,188
RAUNAS NOVADS,School.Females,7,172,0,0,179
RAUNAS NOVADS,Children.All,63,499,0,3,565
RĒZEKNES NOVADS,Preschool.All,27,1691,1,2,1721
RĒZEKNES NOVADS,Preschool.Males,16,834,1,0,851
RĒZEKNES NOVADS,Preschool.Females,11,857,0,2,870
RĒZEKNES NOVADS,School.All,12,3192,2,8,3214
RĒZEKNES NOVADS,School.Males,9,1663,2,3,1677
RĒZEKNES NOVADS,School.Females,3,1529,0,5,1537
RĒZEKNES NOVADS,Children.All,39,4883,3,10,4935
RIEBIŅU NOVADS,Preschool.All,12,219,0,0,231
RIEBIŅU NOVADS,Preschool.Males,7,115,0,0,122
RIEBIŅU NOVADS,Preschool.Females,5,104,0,0,109
RIEBIŅU NOVADS,School.All,12,563,0,0,575
RIEBIŅU NOVADS,School.Males,6,313,0,0,319
RIEBIŅU NOVADS,School.Females,6,250,0,0,256
RIEBIŅU NOVADS,Children.All,24,782,0,0,806
ROJAS NOVADS,Preschool.All,8,210,0,1,219
ROJAS NOVADS,Preschool.Males,5,102,0,0,107
ROJAS NOVADS,Preschool.Females,3,108,0,1,112
ROJAS NOVADS,School.All,3,409,0,4,416
ROJAS NOVADS,School.Males,2,193,0,4,199
ROJAS NOVADS,School.Females,1,216,0,0,217
ROJAS NOVADS,Children.All,11,619,0,5,635
ROPAŽU NOVADS,Preschool.All,19,466,0,3,488
ROPAŽU NOVADS,Preschool.Males,10,246,0,1,257
ROPAŽU NOVADS,Preschool.Females,9,220,0,2,231
ROPAŽU NOVADS,School.All,11,696,1,5,713
ROPAŽU NOVADS,School.Males,7,364,0,1,372
ROPAŽU NOVADS,School.Females,4,332,1,4,341
ROPAŽU NOVADS,Children.All,30,1162,1,8,1201
RUCAVAS NOVADS,Preschool.All,1,102,1,0,104
RUCAVAS NOVADS,Preschool.Males,0,45,1,0,46
RUCAVAS NOVADS,Preschool.Females,1,57,0,0,58
RUCAVAS NOVADS,School.All,0,160,0,0,160
RUCAVAS NOVADS,School.Males,0,88,0,0,88
RUCAVAS NOVADS,School.Females,0,72,0,0,72
RUCAVAS NOVADS,Children.All,1,262,1,0,264
RUGĀJU NOVADS,Preschool.All,3,128,0,0,131
RUGĀJU NOVADS,Preschool.Males,0,65,0,0,65
RUGĀJU NOVADS,Preschool.Females,3,63,0,0,66
RUGĀJU NOVADS,School.All,1,262,0,0,263
RUGĀJU NOVADS,School.Males,0,127,0,0,127
RUGĀJU NOVADS,School.Females,1,135,0,0,136
RUGĀJU NOVADS,Children.All,4,390,0,0,394
RUNDĀLES NOVADS,Preschool.All,22,233,0,0,255
RUNDĀLES NOVADS,Preschool.Males,11,130,0,0,141
RUNDĀLES NOVADS,Preschool.Females,11,103,0,0,114
RUNDĀLES NOVADS,School.All,1,391,0,3,395
RUNDĀLES NOVADS,School.Males,1,206,0,1,208
RUNDĀLES NOVADS,School.Females,0,185,0,2,187
RUNDĀLES NOVADS,Children.All,23,624,0,3,650
RŪJIENAS NOVADS,Preschool.All,4,296,0,0,300
RŪJIENAS NOVADS,Preschool.Males,2,154,0,0,156
RŪJIENAS NOVADS,Preschool.Females,2,142,0,0,144
RŪJIENAS NOVADS,School.All,9,543,0,1,553
RŪJIENAS NOVADS,School.Males,7,262,0,0,269
RŪJIENAS NOVADS,School.Females,2,281,0,1,284
RŪJIENAS NOVADS,Children.All,13,839,0,1,853
SALACGRĪVAS NOVADS,Preschool.All,5,417,1,0,423
SALACGRĪVAS NOVADS,Preschool.Males,1,226,1,0,228
SALACGRĪVAS NOVADS,Preschool.Females,4,191,0,0,195
SALACGRĪVAS NOVADS,School.All,2,819,0,4,825
SALACGRĪVAS NOVADS,School.Males,1,414,0,2,417
SALACGRĪVAS NOVADS,School.Females,1,405,0,2,408
SALACGRĪVAS NOVADS,Children.All,7,1236,1,4,1248
SALAS NOVADS,Preschool.All,2,276,2,0,280
SALAS NOVADS,Preschool.Males,2,147,0,0,149
SALAS NOVADS,Preschool.Females,0,129,2,0,131
SALAS NOVADS,School.All,4,425,2,0,431
SALAS NOVADS,School.Males,1,237,1,0,239
SALAS NOVADS,School.Females,3,188,1,0,192
SALAS NOVADS,Children.All,6,701,4,0,711
SALASPILS NOVADS,Preschool.All,19,1903,1,8,1931
SALASPILS NOVADS,Preschool.Males,8,1002,1,2,1013
SALASPILS NOVADS,Preschool.Females,11,901,0,6,918
SALASPILS NOVADS,School.All,11,2464,0,24,2499
SALASPILS NOVADS,School.Males,2,1265,0,9,1276
SALASPILS NOVADS,School.Females,9,1199,0,15,1223
SALASPILS NOVADS,Children.All,30,4367,1,32,4430
SALDUS NOVADS,Preschool.All,28,1721,1,6,1756
SALDUS NOVADS,Preschool.Males,12,865,0,3,880
SALDUS NOVADS,Preschool.Females,16,856,1,3,876
SALDUS NOVADS,School.All,11,3039,0,34,3084
SALDUS NOVADS,School.Males,8,1537,0,16,1561
SALDUS NOVADS,School.Females,3,1502,0,18,1523
SALDUS NOVADS,Children.All,39,4760,1,40,4840
SAULKRASTU NOVADS,Preschool.All,8,403,1,2,414
SAULKRASTU NOVADS,Preschool.Males,3,202,0,2,207
SAULKRASTU NOVADS,Preschool.Females,5,201,1,0,207
SAULKRASTU NOVADS,School.All,23,589,0,1,613
SAULKRASTU NOVADS,School.Males,13,294,0,1,308
SAULKRASTU NOVADS,School.Females,10,295,0,0,305
SAULKRASTU NOVADS,Children.All,31,992,1,3,1027
SĒJAS NOVADS,Preschool.All,9,149,0,0,158
SĒJAS NOVADS,Preschool.Males,5,67,0,0,72
SĒJAS NOVADS,Preschool.Females,4,82,0,0,86
SĒJAS NOVADS,School.All,0,270,1,0,271
SĒJAS NOVADS,School.Males,0,133,0,0,133
SĒJAS NOVADS,School.Females,0,137,1,0,138
SĒJAS NOVADS,Children.All,9,419,1,0,429
SIGULDAS NOVADS,Preschool.All,5,1683,0,1,1689
SIGULDAS NOVADS,Preschool.Males,4,854,0,1,859
SIGULDAS NOVADS,Preschool.Females,1,829,0,0,830
SIGULDAS NOVADS,School.All,6,1969,0,17,1992
SIGULDAS NOVADS,School.Males,3,974,0,9,986
SIGULDAS NOVADS,School.Females,3,995,0,8,1006
SIGULDAS NOVADS,Children.All,11,3652,0,18,3681
SKRĪVERU NOVADS,Preschool.All,5,238,0,2,245
SKRĪVERU NOVADS,Preschool.Males,2,131,0,0,133
SKRĪVERU NOVADS,Preschool.Females,3,107,0,2,112
SKRĪVERU NOVADS,School.All,0,357,0,5,362
SKRĪVERU NOVADS,School.Males,0,162,0,1,163
SKRĪVERU NOVADS,School.Females,0,195,0,4,199
SKRĪVERU NOVADS,Children.All,5,595,0,7,607
SKRUNDAS NOVADS,Preschool.All,21,273,1,2,297
SKRUNDAS NOVADS,Preschool.Males,12,144,1,1,158
SKRUNDAS NOVADS,Preschool.Females,9,129,0,1,139
SKRUNDAS NOVADS,School.All,5,635,0,1,641
SKRUNDAS NOVADS,School.Males,4,314,0,1,319
SKRUNDAS NOVADS,School.Females,1,321,0,0,322
SKRUNDAS NOVADS,Children.All,26,908,1,3,938
SMILTENES NOVADS,Preschool.All,22,915,0,1,938
SMILTENES NOVADS,Preschool.Males,9,474,0,1,484
SMILTENES NOVADS,Preschool.Females,13,441,0,0,454
SMILTENES NOVADS,School.All,3,1474,0,4,1481
SMILTENES NOVADS,School.Males,2,762,0,2,766
SMILTENES NOVADS,School.Females,1,712,0,2,715
SMILTENES NOVADS,Children.All,25,2389,0,5,2419
STOPIŅU NOVADS,Preschool.All,19,965,0,1,985
STOPIŅU NOVADS,Preschool.Males,16,485,0,1,502
STOPIŅU NOVADS,Preschool.Females,3,480,0,0,483
STOPIŅU NOVADS,School.All,4,1278,1,8,1291
STOPIŅU NOVADS,School.Males,2,674,1,4,681
STOPIŅU NOVADS,School.Females,2,604,0,4,610
STOPIŅU NOVADS,Children.All,23,2243,1,9,2276
STRENČU NOVADS,Preschool.All,6,166,0,0,172
STRENČU NOVADS,Preschool.Males,2,76,0,0,78
STRENČU NOVADS,Preschool.Females,4,90,0,0,94
STRENČU NOVADS,School.All,1,361,0,5,367
STRENČU NOVADS,School.Males,1,195,0,2,198
STRENČU NOVADS,School.Females,0,166,0,3,169
STRENČU NOVADS,Children.All,7,527,0,5,539
TALSU NOVADS,Preschool.All,41,2046,0,11,2098
TALSU NOVADS,Preschool.Males,19,1062,0,7,1088
TALSU NOVADS,Preschool.Females,22,984,0,4,1010
TALSU NOVADS,School.All,9,3464,0,56,3529
TALSU NOVADS,School.Males,4,1804,0,31,1839
TALSU NOVADS,School.Females,5,1660,0,25,1690
TALSU NOVADS,Children.All,50,5510,0,67,5627
TĒRVETES NOVADS,Preschool.All,3,216,0,0,219
TĒRVETES NOVADS,Preschool.Males,3,115,0,0,118
TĒRVETES NOVADS,Preschool.Females,0,101,0,0,101
TĒRVETES NOVADS,School.All,1,369,0,1,371
TĒRVETES NOVADS,School.Males,0,192,0,1,193
TĒRVETES NOVADS,School.Females,1,177,0,0,178
TĒRVETES NOVADS,Children.All,4,585,0,1,590
TUKUMA NOVADS,Preschool.All,29,2328,4,12,2373
TUKUMA NOVADS,Preschool.Males,16,1226,2,8,1252
TUKUMA NOVADS,Preschool.Females,13,1102,2,4,1121
TUKUMA NOVADS,School.All,28,3611,10,57,3706
TUKUMA NOVADS,School.Males,19,1845,5,34,1903
TUKUMA NOVADS,School.Females,9,1766,5,23,1803
TUKUMA NOVADS,Children.All,57,5939,14,69,6079
VAIŅODES NOVADS,Preschool.All,0,165,0,0,165
VAIŅODES NOVADS,Preschool.Males,0,82,0,0,82
VAIŅODES NOVADS,Preschool.Females,0,83,0,0,83
VAIŅODES NOVADS,School.All,1,307,0,1,309
VAIŅODES NOVADS,School.Males,1,162,0,0,163
VAIŅODES NOVADS,School.Females,0,145,0,1,146
VAIŅODES NOVADS,Children.All,1,472,0,1,474
VALKAS NOVADS,Preschool.All,15,524,0,0,539
VALKAS NOVADS,Preschool.Males,8,287,0,0,295
VALKAS NOVADS,Preschool.Females,7,237,0,0,244
VALKAS NOVADS,School.All,2,892,0,8,902
VALKAS NOVADS,School.Males,1,471,0,4,476
VALKAS NOVADS,School.Females,1,421,0,4,426
VALKAS NOVADS,Children.All,17,1416,0,8,1441
VARAKĻĀNU NOVADS,Preschool.All,4,170,0,0,174
VARAKĻĀNU NOVADS,Preschool.Males,1,99,0,0,100
VARAKĻĀNU NOVADS,Preschool.Females,3,71,0,0,74
VARAKĻĀNU NOVADS,School.All,2,352,0,0,354
VARAKĻĀNU NOVADS,School.Males,1,190,0,0,191
VARAKĻĀNU NOVADS,School.Females,1,162,0,0,163
VARAKĻĀNU NOVADS,Children.All,6,522,0,0,528
VĀRKAVAS NOVADS,Preschool.All,6,110,0,0,116
VĀRKAVAS NOVADS,Preschool.Males,2,51,0,0,53
VĀRKAVAS NOVADS,Preschool.Females,4,59,0,0,63
VĀRKAVAS NOVADS,School.All,12,187,0,0,199
VĀRKAVAS NOVADS,School.Males,6,94,0,0,100
VĀRKAVAS NOVADS,School.Females,6,93,0,0,99
VĀRKAVAS NOVADS,Children.All,18,297,0,0,315
VECPIEBALGAS NOVADS,Preschool.All,18,216,0,1,235
VECPIEBALGAS NOVADS,Preschool.Males,9,106,0,1,116
VECPIEBALGAS NOVADS,Preschool.Females,9,110,0,0,119
VECPIEBALGAS NOVADS,School.All,18,416,1,5,440
VECPIEBALGAS NOVADS,School.Males,9,222,1,4,236
VECPIEBALGAS NOVADS,School.Females,9,194,0,1,204
VECPIEBALGAS NOVADS,Children.All,36,632,1,6,675
VECUMNIEKU NOVADS,Preschool.All,4,555,2,0,561
VECUMNIEKU NOVADS,Preschool.Males,3,288,1,0,292
VECUMNIEKU NOVADS,Preschool.Females,1,267,1,0,269
VECUMNIEKU NOVADS,School.All,2,949,0,1,952
VECUMNIEKU NOVADS,School.Males,1,504,0,0,505
VECUMNIEKU NOVADS,School.Females,1,445,0,1,447
VECUMNIEKU NOVADS,Children.All,6,1504,2,1,1513
VENTSPILS NOVADS,Preschool.All,18,777,0,4,799
VENTSPILS NOVADS,Preschool.Males,10,382,0,3,395
VENTSPILS NOVADS,Preschool.Females,8,395,0,1,404
VENTSPILS NOVADS,School.All,9,1441,2,12,1464
VENTSPILS NOVADS,School.Males,6,761,1,6,774
VENTSPILS NOVADS,School.Females,3,680,1,6,690
VENTSPILS NOVADS,Children.All,27,2218,2,16,2263
VIESĪTES NOVADS,Preschool.All,8,237,0,0,245
VIESĪTES NOVADS,Preschool.Males,5,127,0,0,132
VIESĪTES NOVADS,Preschool.Females,3,110,0,0,113
VIESĪTES NOVADS,School.All,1,444,0,0,445
VIESĪTES NOVADS,School.Males,1,228,0,0,229
VIESĪTES NOVADS,School.Females,0,216,0,0,216
VIESĪTES NOVADS,Children.All,9,681,0,0,690
VIĻAKAS NOVADS,Preschool.All,14,225,2,0,241
VIĻAKAS NOVADS,Preschool.Males,10,111,2,0,123
VIĻAKAS NOVADS,Preschool.Females,4,114,0,0,118
VIĻAKAS NOVADS,School.All,2,599,0,2,603
VIĻAKAS NOVADS,School.Males,1,309,0,1,311
VIĻAKAS NOVADS,School.Females,1,290,0,1,292
VIĻAKAS NOVADS,Children.All,16,824,2,2,844
VIĻĀNU NOVADS,Preschool.All,6,342,0,0,348
VIĻĀNU NOVADS,Preschool.Males,4,164,0,0,168
VIĻĀNU NOVADS,Preschool.Females,2,178,0,0,180
VIĻĀNU NOVADS,School.All,0,646,0,0,646
VIĻĀNU NOVADS,School.Males,0,304,0,0,304
VIĻĀNU NOVADS,School.Females,0,342,0,0,342
VIĻĀNU NOVADS,Children.All,6,988,0,0,994
ZILUPES NOVADS,Preschool.All,4,148,0,0,152
ZILUPES NOVADS,Preschool.Males,1,78,0,0,79
ZILUPES NOVADS,Preschool.Females,3,70,0,0,73
ZILUPES NOVADS,School.All,1,371,0,0,372
ZILUPES NOVADS,School.Males,1,191,0,0,192
ZILUPES NOVADS,School.Females,0,180,0,0,180
ZILUPES NOVADS,Children.All,5,519,0,0,524
