DAUGAVPILS,142,6114,1,14,6271
 T.SK. VĪRIEŠI,81,3184,1,7,3273
 T.SK. SIEVIETES,61,2930,0,7,2998
 7-18(NEIESKAITOT) GADU VECUMĀ,49,9100,0,120,9269
 T.SK. VĪRIEŠI,25,4631,0,59,4715
 T.SK. SIEVIETES,24,4469,0,61,4554
Kopā,191,15214,1,134,15540
JELGAVA,68,4924,0,27,5019
 T.SK. VĪRIEŠI,34,2505,0,19,2558
 T.SK. SIEVIETES,34,2419,0,8,2461
 7-18(NEIESKAITOT) GADU VECUMĀ,13,6591,0,155,6759
 T.SK. VĪRIEŠI,4,3273,0,79,3356
 T.SK. SIEVIETES,9,3318,0,76,3403
Kopā,81,11515,0,182,11778
JĒKABPILS,40,1538,6,17,1601
 T.SK. VĪRIEŠI,20,793,1,8,822
 T.SK. SIEVIETES,20,745,5,9,779
 7-18(NEIESKAITOT) GADU VECUMĀ,1,2445,193,110,2749
 T.SK. VĪRIEŠI,0,1213,101,62,1376
 T.SK. SIEVIETES,1,1232,92,48,1373
Kopā,41,3983,199,127,4350
JŪRMALA,108,3749,0,20,3877
 T.SK. VĪRIEŠI,56,1955,0,16,2027
 T.SK. SIEVIETES,52,1794,0,4,1850
 7-18(NEIESKAITOT) GADU VECUMĀ,45,5698,0,92,5835
 T.SK. VĪRIEŠI,22,2945,0,49,3016
 T.SK. SIEVIETES,23,2753,0,43,2819
Kopā,153,9447,0,112,9712
LIEPĀJA,68,5597,7,54,5726
 T.SK. VĪRIEŠI,42,2867,2,24,2935
 T.SK. SIEVIETES,26,2730,5,30,2791
 7-18(NEIESKAITOT) GADU VECUMĀ,33,8421,2,203,8659
 T.SK. VĪRIEŠI,19,4298,2,101,4420
 T.SK. SIEVIETES,14,4123,0,102,4239
Kopā,101,14018,9,257,14385
RĒZEKNE,35,1919,0,10,1964
 T.SK. VĪRIEŠI,15,991,0,7,1013
 T.SK. SIEVIETES,20,928,0,3,951
 7-18(NEIESKAITOT) GADU VECUMĀ,21,3215,0,43,3279
 T.SK. VĪRIEŠI,10,1671,0,18,1699
 T.SK. SIEVIETES,11,1544,0,25,1580
Kopā,56,5134,0,53,5243
RĪGA,2664,47748,12,220,50644
 T.SK. VĪRIEŠI,1353,24444,7,116,25920
 T.SK. SIEVIETES,1311,23304,5,104,24724
 7-18(NEIESKAITOT) GADU VECUMĀ,759,61871,21,952,63603
 T.SK. VĪRIEŠI,380,31758,11,515,32664
 T.SK. SIEVIETES,379,30113,10,437,30939
Kopā,3423,109619,33,1172,114247
VALMIERA,18,1873,0,24,1915
 T.SK. VĪRIEŠI,9,973,0,12,994
 T.SK. SIEVIETES,9,900,0,12,921
 7-18(NEIESKAITOT) GADU VECUMĀ,6,2505,24,52,2587
 T.SK. VĪRIEŠI,3,1274,8,26,1311
 T.SK. SIEVIETES,3,1231,16,26,1276
Kopā,24,4378,24,76,4502
VENTSPILS,107,2492,0,23,2622
 T.SK. VĪRIEŠI,59,1283,0,8,1350
 T.SK. SIEVIETES,48,1209,0,15,1272
 7-18(NEIESKAITOT) GADU VECUMĀ,26,3972,0,83,4081
 T.SK. VĪRIEŠI,19,1955,0,43,2017
 T.SK. SIEVIETES,7,2017,0,40,2064
Kopā,133,6464,0,106,6703
AGLONAS NOVADS,11,194,0,3,208
 T.SK. VĪRIEŠI,4,98,0,2,104
 T.SK. SIEVIETES,7,96,0,1,104
 7-18(NEIESKAITOT) GADU VECUMĀ,4,386,0,1,391
 T.SK. VĪRIEŠI,3,194,0,0,197
 T.SK. SIEVIETES,1,192,0,1,194
Kopā,15,580,0,4,599
AIZKRAUKLES NOVADS,26,520,0,4,550
 T.SK. VĪRIEŠI,16,291,0,1,308
 T.SK. SIEVIETES,10,229,0,3,242
 7-18(NEIESKAITOT) GADU VECUMĀ,15,883,1,9,908
 T.SK. VĪRIEŠI,6,467,0,5,478
 T.SK. SIEVIETES,9,416,1,4,430
Kopā,41,1403,1,13,1458
AIZPUTES NOVADS,9,600,0,1,610
 T.SK. VĪRIEŠI,5,309,0,1,315
 T.SK. SIEVIETES,4,291,0,0,295
 7-18(NEIESKAITOT) GADU VECUMĀ,11,1080,1,9,1101
 T.SK. VĪRIEŠI,3,576,0,6,585
 T.SK. SIEVIETES,8,504,1,3,516
Kopā,20,1680,1,10,1711
AKNĪSTES NOVADS,2,145,0,0,147
 T.SK. VĪRIEŠI,0,80,0,0,80
 T.SK. SIEVIETES,2,65,0,0,67
 7-18(NEIESKAITOT) GADU VECUMĀ,0,256,1,0,257
 T.SK. VĪRIEŠI,0,129,0,0,129
 T.SK. SIEVIETES,0,127,1,0,128
Kopā,2,401,1,0,404
ALOJAS NOVADS,17,319,0,0,336
 T.SK. VĪRIEŠI,13,169,0,0,182
 T.SK. SIEVIETES,4,150,0,0,154
 7-18(NEIESKAITOT) GADU VECUMĀ,22,544,0,0,566
 T.SK. VĪRIEŠI,12,267,0,0,279
 T.SK. SIEVIETES,10,277,0,0,287
Kopā,39,863,0,0,902
ALSUNGAS NOVADS,4,80,0,0,84
 T.SK. VĪRIEŠI,2,44,0,0,46
 T.SK. SIEVIETES,2,36,0,0,38
 7-18(NEIESKAITOT) GADU VECUMĀ,0,165,2,1,168
 T.SK. VĪRIEŠI,0,73,1,1,75
 T.SK. SIEVIETES,0,92,1,0,93
Kopā,4,245,2,1,252
ALŪKSNES NOVADS,48,1014,2,2,1066
 T.SK. VĪRIEŠI,26,516,0,2,544
 T.SK. SIEVIETES,22,498,2,0,522
 7-18(NEIESKAITOT) GADU VECUMĀ,2,1795,4,8,1809
 T.SK. VĪRIEŠI,2,888,3,3,896
 T.SK. SIEVIETES,0,907,1,5,913
Kopā,50,2809,6,10,2875
AMATAS NOVADS,26,346,0,0,372
 T.SK. VĪRIEŠI,10,176,0,0,186
 T.SK. SIEVIETES,16,170,0,0,186
 7-18(NEIESKAITOT) GADU VECUMĀ,9,677,0,1,687
 T.SK. VĪRIEŠI,5,353,0,1,359
 T.SK. SIEVIETES,4,324,0,0,328
Kopā,35,1023,0,1,1059
APES NOVADS,4,232,0,0,236
 T.SK. VĪRIEŠI,2,120,0,0,122
 T.SK. SIEVIETES,2,112,0,0,114
 7-18(NEIESKAITOT) GADU VECUMĀ,0,398,0,0,398
 T.SK. VĪRIEŠI,0,204,0,0,204
 T.SK. SIEVIETES,0,194,0,0,194
Kopā,4,630,0,0,634
AUCES NOVADS,12,417,0,2,431
 T.SK. VĪRIEŠI,8,224,0,2,234
 T.SK. SIEVIETES,4,193,0,0,197
 7-18(NEIESKAITOT) GADU VECUMĀ,2,820,0,9,831
 T.SK. VĪRIEŠI,1,414,0,5,420
 T.SK. SIEVIETES,1,406,0,4,411
Kopā,14,1237,0,11,1262
ĀDAŽU NOVADS,16,1127,0,1,1144
 T.SK. VĪRIEŠI,6,579,0,1,586
 T.SK. SIEVIETES,10,548,0,0,558
 7-18(NEIESKAITOT) GADU VECUMĀ,7,1405,0,22,1434
 T.SK. VĪRIEŠI,2,716,0,10,728
 T.SK. SIEVIETES,5,689,0,12,706
Kopā,23,2532,0,23,2578
BABĪTES NOVADS,10,1046,0,2,1058
 T.SK. VĪRIEŠI,5,515,0,1,521
 T.SK. SIEVIETES,5,531,0,1,537
 7-18(NEIESKAITOT) GADU VECUMĀ,6,1383,0,8,1397
 T.SK. VĪRIEŠI,0,699,0,3,702
 T.SK. SIEVIETES,6,684,0,5,695
Kopā,16,2429,0,10,2455
BALDONES NOVADS,2,434,0,1,437
 T.SK. VĪRIEŠI,1,227,0,1,229
 T.SK. SIEVIETES,1,207,0,0,208
 7-18(NEIESKAITOT) GADU VECUMĀ,6,728,0,6,740
 T.SK. VĪRIEŠI,2,382,0,4,388
 T.SK. SIEVIETES,4,346,0,2,352
Kopā,8,1162,0,7,1177
BALTINAVAS NOVADS,0,51,0,0,51
 T.SK. VĪRIEŠI,0,27,0,0,27
 T.SK. SIEVIETES,0,24,0,0,24
 7-18(NEIESKAITOT) GADU VECUMĀ,1,113,0,0,114
 T.SK. VĪRIEŠI,0,55,0,0,55
 T.SK. SIEVIETES,1,58,0,0,59
Kopā,1,164,0,0,165
BALVU NOVADS,28,768,1,4,801
 T.SK. VĪRIEŠI,18,410,1,1,430
 T.SK. SIEVIETES,10,358,0,3,371
 7-18(NEIESKAITOT) GADU VECUMĀ,7,1422,0,9,1438
 T.SK. VĪRIEŠI,3,746,0,7,756
 T.SK. SIEVIETES,4,676,0,2,682
Kopā,35,2190,1,13,2239
BAUSKAS NOVADS,49,1672,2,7,1730
 T.SK. VĪRIEŠI,26,861,1,6,894
 T.SK. SIEVIETES,23,811,1,1,836
 7-18(NEIESKAITOT) GADU VECUMĀ,9,2769,0,13,2791
 T.SK. VĪRIEŠI,5,1399,0,8,1412
 T.SK. SIEVIETES,4,1370,0,5,1379
Kopā,58,4441,2,20,4521
BEVERĪNAS NOVADS,8,221,2,1,232
 T.SK. VĪRIEŠI,4,118,1,0,123
 T.SK. SIEVIETES,4,103,1,1,109
 7-18(NEIESKAITOT) GADU VECUMĀ,2,329,0,1,332
 T.SK. VĪRIEŠI,0,171,0,1,172
 T.SK. SIEVIETES,2,158,0,0,160
 Kopā,10,550,2,2,564
BROCĒNU NOVADS,1,392,0,3,396
 T.SK. VĪRIEŠI,1,198,0,1,200
 T.SK. SIEVIETES,0,194,0,2,196
 7-18(NEIESKAITOT) GADU VECUMĀ,10,712,0,2,724
 T.SK. VĪRIEŠI,5,367,0,2,374
 T.SK. SIEVIETES,5,345,0,0,350
Kopā,11,1104,0,5,1120
BURTNIEKU NOVADS,2,549,0,0,551
 T.SK. VĪRIEŠI,0,277,0,0,277
 T.SK. SIEVIETES,2,272,0,0,274
 7-18(NEIESKAITOT) GADU VECUMĀ,4,866,0,1,871
 T.SK. VĪRIEŠI,3,443,0,1,447
 T.SK. SIEVIETES,1,423,0,0,424
Kopā,6,1415,0,1,1422
CARNIKAVAS NOVADS,9,520,1,0,530
 T.SK. VĪRIEŠI,7,262,0,0,269
 T.SK. SIEVIETES,2,258,1,0,261
 7-18(NEIESKAITOT) GADU VECUMĀ,7,646,0,9,662
 T.SK. VĪRIEŠI,5,348,0,5,358
 T.SK. SIEVIETES,2,298,0,4,304
Kopā,16,1166,1,9,1192
CESVAINES NOVADS,1,124,0,0,125
 T.SK. VĪRIEŠI,1,70,0,0,71
 T.SK. SIEVIETES,0,54,0,0,54
 7-18(NEIESKAITOT) GADU VECUMĀ,0,302,3,0,305
 T.SK. VĪRIEŠI,0,168,2,0,170
 T.SK. SIEVIETES,0,134,1,0,135
Kopā,1,426,3,0,430
CĒSU NOVADS,27,1297,0,6,1330
 T.SK. VĪRIEŠI,16,670,0,1,687
 T.SK. SIEVIETES,11,627,0,5,643
 7-18(NEIESKAITOT) GADU VECUMĀ,7,1847,0,29,1883
 T.SK. VĪRIEŠI,3,929,0,16,948
 T.SK. SIEVIETES,4,918,0,13,935
Kopā,34,3144,0,35,3213
CIBLAS NOVADS,6,153,0,0,159
 T.SK. VĪRIEŠI,3,71,0,0,74
 T.SK. SIEVIETES,3,82,0,0,85
 7-18(NEIESKAITOT) GADU VECUMĀ,2,262,1,0,265
 T.SK. VĪRIEŠI,1,125,1,0,127
 T.SK. SIEVIETES,1,137,0,0,138
Kopā,8,415,1,0,424
DAGDAS NOVADS,11,384,0,0,395
 T.SK. VĪRIEŠI,6,198,0,0,204
 T.SK. SIEVIETES,5,186,0,0,191
 7-18(NEIESKAITOT) GADU VECUMĀ,15,838,1,0,854
 T.SK. VĪRIEŠI,6,434,1,0,441
 T.SK. SIEVIETES,9,404,0,0,413
Kopā,26,1222,1,0,1249
DAUGAVPILS NOVADS,60,1251,1,1,1313
 T.SK. VĪRIEŠI,29,644,0,0,673
 T.SK. SIEVIETES,31,607,1,1,640
 7-18(NEIESKAITOT) GADU VECUMĀ,11,2267,2,19,2299
 T.SK. VĪRIEŠI,5,1166,2,9,1182
 T.SK. SIEVIETES,6,1101,0,10,1117
Kopā,71,3518,3,20,3612
DOBELES NOVADS,13,1432,1,6,1452
 T.SK. VĪRIEŠI,5,738,1,3,747
 T.SK. SIEVIETES,8,694,0,3,705
 7-18(NEIESKAITOT) GADU VECUMĀ,8,2444,0,25,2477
 T.SK. VĪRIEŠI,5,1237,0,12,1254
 T.SK. SIEVIETES,3,1207,0,13,1223
Kopā,21,3876,1,31,3929
DUNDAGAS NOVADS,6,255,0,0,261
 T.SK. VĪRIEŠI,4,132,0,0,136
 T.SK. SIEVIETES,2,123,0,0,125
 7-18(NEIESKAITOT) GADU VECUMĀ,21,427,0,1,449
 T.SK. VĪRIEŠI,10,232,0,0,242
 T.SK. SIEVIETES,11,195,0,1,207
Kopā,27,682,0,1,710
DURBES NOVADS,0,175,0,0,175
 T.SK. VĪRIEŠI,0,86,0,0,86
 T.SK. SIEVIETES,0,89,0,0,89
 7-18(NEIESKAITOT) GADU VECUMĀ,0,315,0,4,319
 T.SK. VĪRIEŠI,0,159,0,1,160
 T.SK. SIEVIETES,0,156,0,3,159
Kopā,0,490,0,4,494
ENGURES NOVADS,12,401,0,0,413
 T.SK. VĪRIEŠI,7,205,0,0,212
 T.SK. SIEVIETES,5,196,0,0,201
 7-18(NEIESKAITOT) GADU VECUMĀ,3,728,0,1,732
 T.SK. VĪRIEŠI,2,389,0,0,391
 T.SK. SIEVIETES,1,339,0,1,341
Kopā,15,1129,0,1,1145
ĒRGĻU NOVADS,6,165,0,0,171
 T.SK. VĪRIEŠI,3,80,0,0,83
 T.SK. SIEVIETES,3,85,0,0,88
 7-18(NEIESKAITOT) GADU VECUMĀ,2,304,0,0,306
 T.SK. VĪRIEŠI,0,141,0,0,141
 T.SK. SIEVIETES,2,163,0,0,165
Kopā,8,469,0,0,477
GARKALNES NOVADS,19,693,0,0,712
 T.SK. VĪRIEŠI,8,357,0,0,365
 T.SK. SIEVIETES,11,336,0,0,347
 7-18(NEIESKAITOT) GADU VECUMĀ,13,1057,0,5,1075
 T.SK. VĪRIEŠI,7,555,0,4,566
 T.SK. SIEVIETES,6,502,0,1,509
Kopā,32,1750,0,5,1787
GROBIŅAS NOVADS,7,623,0,1,631
T.SK. VĪRIEŠI,3,314,0,1,318
 T.SK. SIEVIETES,4,309,0,0,313
 7-18(NEIESKAITOT) GADU VECUMĀ,4,1086,0,8,1098
 T.SK. VĪRIEŠI,3,567,0,2,572
 T.SK. SIEVIETES,1,519,0,6,526
Kopā,11,1709,0,9,1729
GULBENES NOVADS,25,1346,4,4,1379
 T.SK. VĪRIEŠI,13,679,0,2,694
 T.SK. SIEVIETES,12,667,4,2,685
 7-18(NEIESKAITOT) GADU VECUMĀ,11,2411,1,13,2436
 T.SK. VĪRIEŠI,7,1280,0,6,1293
 T.SK. SIEVIETES,4,1131,1,7,1143
Kopā,36,3757,5,17,3815
IECAVAS NOVADS,8,685,1,5,699
 T.SK. VĪRIEŠI,3,344,1,3,351
 T.SK. SIEVIETES,5,341,0,2,348
 7-18(NEIESKAITOT) GADU VECUMĀ,13,1080,0,13,1106
 T.SK. VĪRIEŠI,7,562,0,6,575
 T.SK. SIEVIETES,6,518,0,7,531
Kopā,21,1765,1,18,1805
IKŠĶILES NOVADS,4,909,0,3,916
 T.SK. VĪRIEŠI,1,475,0,3,479
 T.SK. SIEVIETES,3,434,0,0,437
 7-18(NEIESKAITOT) GADU VECUMĀ,1,1181,0,6,1188
 T.SK. VĪRIEŠI,0,576,0,4,580
 T.SK. SIEVIETES,1,605,0,2,608
Kopā,5,2090,0,9,2104
ILŪKSTES NOVADS,4,404,0,1,409
 T.SK. VĪRIEŠI,2,199,0,0,201
 T.SK. SIEVIETES,2,205,0,1,208
 7-18(NEIESKAITOT) GADU VECUMĀ,1,794,0,4,799
 T.SK. VĪRIEŠI,1,390,0,3,394
 T.SK. SIEVIETES,0,404,0,1,405
Kopā,5,1198,0,5,1208
INČUKALNA NOVADS,15,577,0,3,595
 T.SK. VĪRIEŠI,11,301,0,3,315
 T.SK. SIEVIETES,4,276,0,0,280
 7-18(NEIESKAITOT) GADU VECUMĀ,11,832,0,13,856
 T.SK. VĪRIEŠI,3,438,0,7,448
 T.SK. SIEVIETES,8,394,0,6,408
Kopā,26,1409,0,16,1451
JAUNJELGAVAS NOVADS,13,333,0,2,348
 T.SK. VĪRIEŠI,8,170,0,1,179
 T.SK. SIEVIETES,5,163,0,1,169
 7-18(NEIESKAITOT) GADU VECUMĀ,13,608,1,4,626
 T.SK. VĪRIEŠI,10,305,1,2,318
 T.SK. SIEVIETES,3,303,0,2,308
Kopā,26,941,1,6,974
JAUNPIEBALGAS NOVADS,11,131,0,0,142
 T.SK. VĪRIEŠI,2,59,0,0,61
 T.SK. SIEVIETES,9,72,0,0,81
 7-18(NEIESKAITOT) GADU VECUMĀ,3,258,2,3,266
 T.SK. VĪRIEŠI,0,113,1,1,115
 T.SK. SIEVIETES,3,145,1,2,151
Kopā,14,389,2,3,408
JAUNPILS NOVADS,10,165,0,0,175
 T.SK. VĪRIEŠI,4,82,0,0,86
 T.SK. SIEVIETES,6,83,0,0,89
 7-18(NEIESKAITOT) GADU VECUMĀ,0,276,0,0,276
 T.SK. VĪRIEŠI,0,132,0,0,132
 T.SK. SIEVIETES,0,144,0,0,144
Kopā,10,441,0,0,451
JELGAVAS NOVADS,19,1430,0,5,1454
 T.SK. VĪRIEŠI,15,728,0,3,746
 T.SK. SIEVIETES,4,702,0,2,708
 7-18(NEIESKAITOT) GADU VECUMĀ,28,2583,1,15,2627
 T.SK. VĪRIEŠI,14,1324,0,8,1346
 T.SK. SIEVIETES,14,1259,1,7,1281
Kopā,47,4013,1,20,4081
JĒKABPILS NOVADS,6,256,1,4,267
 T.SK. VĪRIEŠI,2,107,1,3,113
 T.SK. SIEVIETES,4,149,0,1,154
 7-18(NEIESKAITOT) GADU VECUMĀ,2,475,0,0,477
 T.SK. VĪRIEŠI,1,247,0,0,248
 T.SK. SIEVIETES,1,228,0,0,229
 Kopā,8,731,1,4,744
KANDAVAS NOVADS,6,549,0,6,561
 T.SK. VĪRIEŠI,2,294,0,3,299
 T.SK. SIEVIETES,4,255,0,3,262
 7-18(NEIESKAITOT) GADU VECUMĀ,9,1080,0,13,1102
 T.SK. VĪRIEŠI,3,554,0,5,562
 T.SK. SIEVIETES,6,526,0,8,540
Kopā,15,1629,0,19,1663
KĀRSAVAS NOVADS,3,318,0,0,321
 T.SK. VĪRIEŠI,3,140,0,0,143
 T.SK. SIEVIETES,0,178,0,0,178
 7-18(NEIESKAITOT) GADU VECUMĀ,5,633,0,0,638
 T.SK. VĪRIEŠI,3,339,0,0,342
 T.SK. SIEVIETES,2,294,0,0,296
Kopā,8,951,0,0,959
KOCĒNU NOVADS,18,406,0,1,425
 T.SK. VĪRIEŠI,11,223,0,1,235
 T.SK. SIEVIETES,7,183,0,0,190
 7-18(NEIESKAITOT) GADU VECUMĀ,16,661,3,8,688
 T.SK. VĪRIEŠI,9,320,2,5,336
 T.SK. SIEVIETES,7,341,1,3,352
Kopā,34,1067,3,9,1113
KOKNESES NOVADS,1,350,1,0,352
 T.SK. VĪRIEŠI,0,167,0,0,167
 T.SK. SIEVIETES,1,183,1,0,185
 7-18(NEIESKAITOT) GADU VECUMĀ,3,649,0,6,658
 T.SK. VĪRIEŠI,2,340,0,4,346
 T.SK. SIEVIETES,1,309,0,2,312
Kopā,4,999,1,6,1010
KRĀSLAVAS NOVADS,74,742,13,6,835
 T.SK. VĪRIEŠI,35,336,5,3,379
 T.SK. SIEVIETES,39,406,8,3,456
 7-18(NEIESKAITOT) GADU VECUMĀ,17,1670,1,22,1710
 T.SK. VĪRIEŠI,8,864,1,10,883
 T.SK. SIEVIETES,9,806,0,12,827
Kopā,91,2412,14,28,2545
KRIMULDAS NOVADS,3,394,0,0,397
 T.SK. VĪRIEŠI,3,212,0,0,215
 T.SK. SIEVIETES,0,182,0,0,182
 7-18(NEIESKAITOT) GADU VECUMĀ,2,535,0,0,537
 T.SK. VĪRIEŠI,0,275,0,0,275
 T.SK. SIEVIETES,2,260,0,0,262
Kopā,5,929,0,0,934
KRUSTPILS NOVADS,10,406,0,0,416
 T.SK. VĪRIEŠI,3,213,0,0,216
 T.SK. SIEVIETES,7,193,0,0,200
 7-18(NEIESKAITOT) GADU VECUMĀ,0,664,0,1,665
 T.SK. VĪRIEŠI,0,344,0,0,344
 T.SK. SIEVIETES,0,320,0,1,321
Kopā,10,1070,0,1,1081
KULDĪGAS NOVADS,32,1666,0,9,1707
 T.SK. VĪRIEŠI,21,859,0,1,881
 T.SK. SIEVIETES,11,807,0,8,826
 7-18(NEIESKAITOT) GADU VECUMĀ,7,2958,0,45,3010
 T.SK. VĪRIEŠI,5,1498,0,25,1528
 T.SK. SIEVIETES,2,1460,0,20,1482
Kopā,39,4624,0,54,4717
ĶEGUMA NOVADS,9,360,0,3,372
 T.SK. VĪRIEŠI,4,183,0,1,188
 T.SK. SIEVIETES,5,177,0,2,184
 7-18(NEIESKAITOT) GADU VECUMĀ,3,563,0,6,572
 T.SK. VĪRIEŠI,1,293,0,3,297
 T.SK. SIEVIETES,2,270,0,3,275
Kopā,12,923,0,9,944
ĶEKAVAS NOVADS,52,2522,0,4,2578
 T.SK. VĪRIEŠI,29,1293,0,2,1324
 T.SK. SIEVIETES,23,1229,0,2,1254
 7-18(NEIESKAITOT) GADU VECUMĀ,41,2563,0,20,2624
 T.SK. VĪRIEŠI,18,1314,0,11,1343
 T.SK. SIEVIETES,23,1249,0,9,1281
Kopā,93,5085,0,24,5202
LIELVĀRDES NOVADS,7,734,0,6,747
 T.SK. VĪRIEŠI,2,364,0,2,368
 T.SK. SIEVIETES,5,370,0,4,379
 7-18(NEIESKAITOT) GADU VECUMĀ,1,1169,0,17,1187
 T.SK. VĪRIEŠI,1,589,0,6,596
 T.SK. SIEVIETES,0,580,0,11,591
Kopā,8,1903,0,23,1934
LIMBAŽU NOVADS,34,1082,1,7,1124
 T.SK. VĪRIEŠI,23,548,0,2,573
 T.SK. SIEVIETES,11,534,1,5,551
 7-18(NEIESKAITOT) GADU VECUMĀ,13,1802,1,9,1825
 T.SK. VĪRIEŠI,8,935,0,4,947
 T.SK. SIEVIETES,5,867,1,5,878
Kopā,47,2884,2,16,2949
LĪGATNES NOVADS,2,222,0,1,225
 T.SK. VĪRIEŠI,1,118,0,1,120
 T.SK. SIEVIETES,1,104,0,0,105
 7-18(NEIESKAITOT) GADU VECUMĀ,2,334,0,2,338
 T.SK. VĪRIEŠI,0,165,0,1,166
 T.SK. SIEVIETES,2,169,0,1,172
Kopā,4,556,0,3,563
LĪVĀNU NOVADS,11,752,1,1,765
 T.SK. VĪRIEŠI,6,387,0,0,393
 T.SK. SIEVIETES,5,365,1,1,372
 7-18(NEIESKAITOT) GADU VECUMĀ,4,1313,0,5,1322
 T.SK. VĪRIEŠI,2,639,0,3,644
 T.SK. SIEVIETES,2,674,0,2,678
Kopā,15,2065,1,6,2087
LUBĀNAS NOVADS,1,132,0,0,133
T.SK. VĪRIEŠI,0,71,0,0,71
 T.SK. SIEVIETES,1,61,0,0,62
 7-18(NEIESKAITOT) GADU VECUMĀ,0,250,0,0,250
 T.SK. VĪRIEŠI,0,113,0,0,113
 T.SK. SIEVIETES,0,137,0,0,137
Kopā,1,382,0,0,383
LUDZAS NOVADS,8,706,1,2,717
 T.SK. VĪRIEŠI,2,353,0,1,356
 T.SK. SIEVIETES,6,353,1,1,361
 7-18(NEIESKAITOT) GADU VECUMĀ,10,1343,0,15,1368
 T.SK. VĪRIEŠI,4,686,0,6,696
 T.SK. SIEVIETES,6,657,0,9,672
Kopā,18,2049,1,17,2085
MADONAS NOVADS,130,1403,0,9,1542
 T.SK. VĪRIEŠI,73,707,0,6,786
 T.SK. SIEVIETES,57,696,0,3,756
 7-18(NEIESKAITOT) GADU VECUMĀ,41,2528,0,23,2592
 T.SK. VĪRIEŠI,19,1316,0,13,1348
 T.SK. SIEVIETES,22,1212,0,10,1244
Kopā,171,3931,0,32,4134
MAZSALACAS NOVADS,5,187,0,0,192
 T.SK. VĪRIEŠI,4,87,0,0,91
 T.SK. SIEVIETES,1,100,0,0,101
 7-18(NEIESKAITOT) GADU VECUMĀ,4,327,4,3,338
 T.SK. VĪRIEŠI,3,170,0,3,176
 T.SK. SIEVIETES,1,157,4,0,162
Kopā,9,514,4,3,530
MĀLPILS NOVADS,1,245,0,0,246
 T.SK. VĪRIEŠI,0,128,0,0,128
 T.SK. SIEVIETES,1,117,0,0,118
 7-18(NEIESKAITOT) GADU VECUMĀ,1,429,0,0,430
 T.SK. VĪRIEŠI,0,238,0,0,238
 T.SK. SIEVIETES,1,191,0,0,192
Kopā,2,674,0,0,676
MĀRUPES NOVADS,19,2428,2,4,2453
 T.SK. VĪRIEŠI,12,1243,2,2,1259
 T.SK. SIEVIETES,7,1185,0,2,1194
 7-18(NEIESKAITOT) GADU VECUMĀ,2,2381,2,13,2398
 T.SK. VĪRIEŠI,0,1228,2,5,1235
 T.SK. SIEVIETES,2,1153,0,8,1163
Kopā,21,4809,4,17,4851
MĒRSRAGA NOVADS,4,79,0,0,83
 T.SK. VĪRIEŠI,3,39,0,0,42
 T.SK. SIEVIETES,1,40,0,0,41
 7-18(NEIESKAITOT) GADU VECUMĀ,5,171,0,1,177
 T.SK. VĪRIEŠI,1,88,0,1,90
 T.SK. SIEVIETES,4,83,0,0,87
Kopā,9,250,0,1,260
NAUKŠĒNU NOVADS,4,111,0,0,115
 T.SK. VĪRIEŠI,1,57,0,0,58
 T.SK. SIEVIETES,3,54,0,0,57
 7-18(NEIESKAITOT) GADU VECUMĀ,0,220,0,2,222
 T.SK. VĪRIEŠI,0,116,0,1,117
 T.SK. SIEVIETES,0,104,0,1,105
Kopā,4,331,0,2,337
NERETAS NOVADS,6,195,0,0,201
 T.SK. VĪRIEŠI,5,97,0,0,102
 T.SK. SIEVIETES,1,98,0,0,99
 7-18(NEIESKAITOT) GADU VECUMĀ,1,343,0,3,347
 T.SK. VĪRIEŠI,0,192,0,2,194
 T.SK. SIEVIETES,1,151,0,1,153
Kopā,7,538,0,3,548
NĪCAS NOVADS,0,186,0,0,186
 T.SK. VĪRIEŠI,0,104,0,0,104
 T.SK. SIEVIETES,0,82,0,0,82
 7-18(NEIESKAITOT) GADU VECUMĀ,0,349,0,3,352
 T.SK. VĪRIEŠI,0,177,0,2,179
 T.SK. SIEVIETES,0,172,0,1,173
Kopā,0,535,0,3,538
OGRES NOVADS,47,2646,0,10,2703
 T.SK. VĪRIEŠI,25,1326,0,4,1355
 T.SK. SIEVIETES,22,1320,0,6,1348
 7-18(NEIESKAITOT) GADU VECUMĀ,22,3833,0,56,3911
 T.SK. VĪRIEŠI,10,1922,0,42,1974
 T.SK. SIEVIETES,12,1911,0,14,1937
 Kopā,69,6479,0,66,6614
OLAINES NOVADS,15,1448,1,6,1470
 T.SK. VĪRIEŠI,8,708,0,3,719
 T.SK. SIEVIETES,7,740,1,3,751
 7-18(NEIESKAITOT) GADU VECUMĀ,2,2117,0,38,2157
 T.SK. VĪRIEŠI,1,1062,0,18,1081
 T.SK. SIEVIETES,1,1055,0,20,1076
Kopā,17,3565,1,44,3627
OZOLNIEKU NOVADS,21,985,0,2,1008
 T.SK. VĪRIEŠI,11,485,0,0,496
 T.SK. SIEVIETES,10,500,0,2,512
 7-18(NEIESKAITOT) GADU VECUMĀ,8,1194,0,12,1214
 T.SK. VĪRIEŠI,2,593,0,3,598
 T.SK. SIEVIETES,6,601,0,9,616
Kopā,29,2179,0,14,2222
PĀRGAUJAS NOVADS,18,237,0,0,255
 T.SK. VĪRIEŠI,11,135,0,0,146
 T.SK. SIEVIETES,7,102,0,0,109
 7-18(NEIESKAITOT) GADU VECUMĀ,3,427,0,0,430
 T.SK. VĪRIEŠI,2,214,0,0,216
 T.SK. SIEVIETES,1,213,0,0,214
Kopā,21,664,0,0,685
PĀVILOSTAS NOVADS,4,164,0,0,168
 T.SK. VĪRIEŠI,3,93,0,0,96
 T.SK. SIEVIETES,1,71,0,0,72
 7-18(NEIESKAITOT) GADU VECUMĀ,1,273,0,0,274
 T.SK. VĪRIEŠI,0,129,0,0,129
 T.SK. SIEVIETES,1,144,0,0,145
Kopā,5,437,0,0,442
PĻAVIŅU NOVADS,2,326,1,2,331
 T.SK. VĪRIEŠI,0,163,1,2,166
 T.SK. SIEVIETES,2,163,0,0,165
 7-18(NEIESKAITOT) GADU VECUMĀ,0,582,1,2,585
 T.SK. VĪRIEŠI,0,281,1,1,283
 T.SK. SIEVIETES,0,301,0,1,302
Kopā,2,908,2,4,916
PREIĻU NOVADS,13,641,0,3,657
 T.SK. VĪRIEŠI,6,322,0,3,331
 T.SK. SIEVIETES,7,319,0,0,326
 7-18(NEIESKAITOT) GADU VECUMĀ,0,962,0,10,972
 T.SK. VĪRIEŠI,0,476,0,7,483
 T.SK. SIEVIETES,0,486,0,3,489
Kopā,13,1603,0,13,1629
PRIEKULES NOVADS,7,368,0,3,378
 T.SK. VĪRIEŠI,4,185,0,2,191
 T.SK. SIEVIETES,3,183,0,1,187
 7-18(NEIESKAITOT) GADU VECUMĀ,0,677,0,8,685
 T.SK. VĪRIEŠI,0,338,0,2,340
 T.SK. SIEVIETES,0,339,0,6,345
Kopā,7,1045,0,11,1063
PRIEKUĻU NOVADS,12,484,0,2,498
 T.SK. VĪRIEŠI,7,248,0,2,257
 T.SK. SIEVIETES,5,236,0,0,241
 7-18(NEIESKAITOT) GADU VECUMĀ,4,909,1,8,922
 T.SK. VĪRIEŠI,2,465,1,4,472
 T.SK. SIEVIETES,2,444,0,4,450
Kopā,16,1393,1,10,1420
RAUNAS NOVADS,51,145,0,2,198
 T.SK. VĪRIEŠI,21,69,0,2,92
 T.SK. SIEVIETES,30,76,0,0,106
 7-18(NEIESKAITOT) GADU VECUMĀ,12,354,0,1,367
 T.SK. VĪRIEŠI,5,182,0,1,188
 T.SK. SIEVIETES,7,172,0,0,179
Kopā,63,499,0,3,565
RĒZEKNES NOVADS,27,1691,1,2,1721
 T.SK. VĪRIEŠI,16,834,1,0,851
 T.SK. SIEVIETES,11,857,0,2,870
 7-18(NEIESKAITOT) GADU VECUMĀ,12,3192,2,8,3214
 T.SK. VĪRIEŠI,9,1663,2,3,1677
 T.SK. SIEVIETES,3,1529,0,5,1537
Kopā,39,4883,3,10,4935
RIEBIŅU NOVADS,12,219,0,0,231
 T.SK. VĪRIEŠI,7,115,0,0,122
 T.SK. SIEVIETES,5,104,0,0,109
 7-18(NEIESKAITOT) GADU VECUMĀ,12,563,0,0,575
 T.SK. VĪRIEŠI,6,313,0,0,319
 T.SK. SIEVIETES,6,250,0,0,256
Kopā,24,782,0,0,806
ROJAS NOVADS,8,210,0,1,219
 T.SK. VĪRIEŠI,5,102,0,0,107
 T.SK. SIEVIETES,3,108,0,1,112
 7-18(NEIESKAITOT) GADU VECUMĀ,3,409,0,4,416
 T.SK. VĪRIEŠI,2,193,0,4,199
 T.SK. SIEVIETES,1,216,0,0,217
Kopā,11,619,0,5,635
ROPAŽU NOVADS,19,466,0,3,488
 T.SK. VĪRIEŠI,10,246,0,1,257
 T.SK. SIEVIETES,9,220,0,2,231
 7-18(NEIESKAITOT) GADU VECUMĀ,11,696,1,5,713
 T.SK. VĪRIEŠI,7,364,0,1,372
 T.SK. SIEVIETES,4,332,1,4,341
Kopā,30,1162,1,8,1201
RUCAVAS NOVADS,1,102,1,0,104
 T.SK. VĪRIEŠI,0,45,1,0,46
 T.SK. SIEVIETES,1,57,0,0,58
 7-18(NEIESKAITOT) GADU VECUMĀ,0,160,0,0,160
 T.SK. VĪRIEŠI,0,88,0,0,88
 T.SK. SIEVIETES,0,72,0,0,72
Kopā,1,262,1,0,264
RUGĀJU NOVADS,3,128,0,0,131
 T.SK. VĪRIEŠI,0,65,0,0,65
 T.SK. SIEVIETES,3,63,0,0,66
 7-18(NEIESKAITOT) GADU VECUMĀ,1,262,0,0,263
 T.SK. VĪRIEŠI,0,127,0,0,127
 T.SK. SIEVIETES,1,135,0,0,136
Kopā,4,390,0,0,394
RUNDĀLES NOVADS,22,233,0,0,255
 T.SK. VĪRIEŠI,11,130,0,0,141
 T.SK. SIEVIETES,11,103,0,0,114
 7-18(NEIESKAITOT) GADU VECUMĀ,1,391,0,3,395
 T.SK. VĪRIEŠI,1,206,0,1,208
 T.SK. SIEVIETES,0,185,0,2,187
Kopā,23,624,0,3,650
RŪJIENAS NOVADS,4,296,0,0,300
 T.SK. VĪRIEŠI,2,154,0,0,156
 T.SK. SIEVIETES,2,142,0,0,144
 7-18(NEIESKAITOT) GADU VECUMĀ,9,543,0,1,553
 T.SK. VĪRIEŠI,7,262,0,0,269
 T.SK. SIEVIETES,2,281,0,1,284
Kopā,13,839,0,1,853
SALACGRĪVAS NOVADS,5,417,1,0,423
 T.SK. VĪRIEŠI,1,226,1,0,228
 T.SK. SIEVIETES,4,191,0,0,195
 7-18(NEIESKAITOT) GADU VECUMĀ,2,819,0,4,825
 T.SK. VĪRIEŠI,1,414,0,2,417
 T.SK. SIEVIETES,1,405,0,2,408
Kopā,7,1236,1,4,1248
SALAS NOVADS,2,276,2,0,280
 T.SK. VĪRIEŠI,2,147,0,0,149
 T.SK. SIEVIETES,0,129,2,0,131
 7-18(NEIESKAITOT) GADU VECUMĀ,4,425,2,0,431
 T.SK. VĪRIEŠI,1,237,1,0,239
 T.SK. SIEVIETES,3,188,1,0,192
Kopā,6,701,4,0,711
SALASPILS NOVADS,19,1903,1,8,1931
 T.SK. VĪRIEŠI,8,1002,1,2,1013
 T.SK. SIEVIETES,11,901,0,6,918
 7-18(NEIESKAITOT) GADU VECUMĀ,11,2464,0,24,2499
 T.SK. VĪRIEŠI,2,1265,0,9,1276
 T.SK. SIEVIETES,9,1199,0,15,1223
Kopā,30,4367,1,32,4430
SALDUS NOVADS,28,1721,1,6,1756
 T.SK. VĪRIEŠI,12,865,0,3,880
 T.SK. SIEVIETES,16,856,1,3,876
 7-18(NEIESKAITOT) GADU VECUMĀ,11,3039,0,34,3084
 T.SK. VĪRIEŠI,8,1537,0,16,1561
 T.SK. SIEVIETES,3,1502,0,18,1523
Kopā,39,4760,1,40,4840
SAULKRASTU NOVADS,8,403,1,2,414
 T.SK. VĪRIEŠI,3,202,0,2,207
 T.SK. SIEVIETES,5,201,1,0,207
 7-18(NEIESKAITOT) GADU VECUMĀ,23,589,0,1,613
 T.SK. VĪRIEŠI,13,294,0,1,308
 T.SK. SIEVIETES,10,295,0,0,305
Kopā,31,992,1,3,1027
SĒJAS NOVADS,9,149,0,0,158
 T.SK. VĪRIEŠI,5,67,0,0,72
 T.SK. SIEVIETES,4,82,0,0,86
 7-18(NEIESKAITOT) GADU VECUMĀ,0,270,1,0,271
 T.SK. VĪRIEŠI,0,133,0,0,133
 T.SK. SIEVIETES,0,137,1,0,138
Kopā,9,419,1,0,429
SIGULDAS NOVADS,5,1683,0,1,1689
 T.SK. VĪRIEŠI,4,854,0,1,859
 T.SK. SIEVIETES,1,829,0,0,830
 7-18(NEIESKAITOT) GADU VECUMĀ,6,1969,0,17,1992
 T.SK. VĪRIEŠI,3,974,0,9,986
 T.SK. SIEVIETES,3,995,0,8,1006
Kopā,11,3652,0,18,3681
SKRĪVERU NOVADS,5,238,0,2,245
 T.SK. VĪRIEŠI,2,131,0,0,133
 T.SK. SIEVIETES,3,107,0,2,112
 7-18(NEIESKAITOT) GADU VECUMĀ,0,357,0,5,362
 T.SK. VĪRIEŠI,0,162,0,1,163
 T.SK. SIEVIETES,0,195,0,4,199
 Kopā,5,595,0,7,607
SKRUNDAS NOVADS,21,273,1,2,297
 T.SK. VĪRIEŠI,12,144,1,1,158
 T.SK. SIEVIETES,9,129,0,1,139
 7-18(NEIESKAITOT) GADU VECUMĀ,5,635,0,1,641
 T.SK. VĪRIEŠI,4,314,0,1,319
 T.SK. SIEVIETES,1,321,0,0,322
Kopā,26,908,1,3,938
SMILTENES NOVADS,22,915,0,1,938
 T.SK. VĪRIEŠI,9,474,0,1,484
 T.SK. SIEVIETES,13,441,0,0,454
 7-18(NEIESKAITOT) GADU VECUMĀ,3,1474,0,4,1481
 T.SK. VĪRIEŠI,2,762,0,2,766
 T.SK. SIEVIETES,1,712,0,2,715
Kopā,25,2389,0,5,2419
STOPIŅU NOVADS,19,965,0,1,985
 T.SK. VĪRIEŠI,16,485,0,1,502
 T.SK. SIEVIETES,3,480,0,0,483
 7-18(NEIESKAITOT) GADU VECUMĀ,4,1278,1,8,1291
 T.SK. VĪRIEŠI,2,674,1,4,681
 T.SK. SIEVIETES,2,604,0,4,610
Kopā,23,2243,1,9,2276
STRENČU NOVADS,6,166,0,0,172
 T.SK. VĪRIEŠI,2,76,0,0,78
 T.SK. SIEVIETES,4,90,0,0,94
 7-18(NEIESKAITOT) GADU VECUMĀ,1,361,0,5,367
 T.SK. VĪRIEŠI,1,195,0,2,198
 T.SK. SIEVIETES,0,166,0,3,169
Kopā,7,527,0,5,539
TALSU NOVADS,41,2046,0,11,2098
 T.SK. VĪRIEŠI,19,1062,0,7,1088
 T.SK. SIEVIETES,22,984,0,4,1010
 7-18(NEIESKAITOT) GADU VECUMĀ,9,3464,0,56,3529
 T.SK. VĪRIEŠI,4,1804,0,31,1839
 T.SK. SIEVIETES,5,1660,0,25,1690
Kopā,50,5510,0,67,5627
TĒRVETES NOVADS,3,216,0,0,219
 T.SK. VĪRIEŠI,3,115,0,0,118
 T.SK. SIEVIETES,0,101,0,0,101
 7-18(NEIESKAITOT) GADU VECUMĀ,1,369,0,1,371
 T.SK. VĪRIEŠI,0,192,0,1,193
 T.SK. SIEVIETES,1,177,0,0,178
Kopā,4,585,0,1,590
TUKUMA NOVADS,29,2328,4,12,2373
 T.SK. VĪRIEŠI,16,1226,2,8,1252
 T.SK. SIEVIETES,13,1102,2,4,1121
 7-18(NEIESKAITOT) GADU VECUMĀ,28,3611,10,57,3706
 T.SK. VĪRIEŠI,19,1845,5,34,1903
 T.SK. SIEVIETES,9,1766,5,23,1803
Kopā,57,5939,14,69,6079
VAIŅODES NOVADS,0,165,0,0,165
 T.SK. VĪRIEŠI,0,82,0,0,82
 T.SK. SIEVIETES,0,83,0,0,83
 7-18(NEIESKAITOT) GADU VECUMĀ,1,307,0,1,309
 T.SK. VĪRIEŠI,1,162,0,0,163
 T.SK. SIEVIETES,0,145,0,1,146
Kopā,1,472,0,1,474
VALKAS NOVADS,15,524,0,0,539
 T.SK. VĪRIEŠI,8,287,0,0,295
 T.SK. SIEVIETES,7,237,0,0,244
 7-18(NEIESKAITOT) GADU VECUMĀ,2,892,0,8,902
 T.SK. VĪRIEŠI,1,471,0,4,476
 T.SK. SIEVIETES,1,421,0,4,426
Kopā,17,1416,0,8,1441
VARAKĻĀNU NOVADS,4,170,0,0,174
 T.SK. VĪRIEŠI,1,99,0,0,100
 T.SK. SIEVIETES,3,71,0,0,74
 7-18(NEIESKAITOT) GADU VECUMĀ,2,352,0,0,354
 T.SK. VĪRIEŠI,1,190,0,0,191
 T.SK. SIEVIETES,1,162,0,0,163
Kopā,6,522,0,0,528
VĀRKAVAS NOVADS,6,110,0,0,116
 T.SK. VĪRIEŠI,2,51,0,0,53
 T.SK. SIEVIETES,4,59,0,0,63
 7-18(NEIESKAITOT) GADU VECUMĀ,12,187,0,0,199
 T.SK. VĪRIEŠI,6,94,0,0,100
 T.SK. SIEVIETES,6,93,0,0,99
Kopā,18,297,0,0,315
VECPIEBALGAS NOVADS,18,216,0,1,235
 T.SK. VĪRIEŠI,9,106,0,1,116
 T.SK. SIEVIETES,9,110,0,0,119
 7-18(NEIESKAITOT) GADU VECUMĀ,18,416,1,5,440
 T.SK. VĪRIEŠI,9,222,1,4,236
 T.SK. SIEVIETES,9,194,0,1,204
Kopā,36,632,1,6,675
VECUMNIEKU NOVADS,4,555,2,0,561
 T.SK. VĪRIEŠI,3,288,1,0,292
 T.SK. SIEVIETES,1,267,1,0,269
 7-18(NEIESKAITOT) GADU VECUMĀ,2,949,0,1,952
 T.SK. VĪRIEŠI,1,504,0,0,505
 T.SK. SIEVIETES,1,445,0,1,447
Kopā,6,1504,2,1,1513
VENTSPILS NOVADS,18,777,0,4,799
 T.SK. VĪRIEŠI,10,382,0,3,395
 T.SK. SIEVIETES,8,395,0,1,404
 7-18(NEIESKAITOT) GADU VECUMĀ,9,1441,2,12,1464
 T.SK. VĪRIEŠI,6,761,1,6,774
 T.SK. SIEVIETES,3,680,1,6,690
Kopā,27,2218,2,16,2263
VIESĪTES NOVADS,8,237,0,0,245
T.SK. VĪRIEŠI,5,127,0,0,132
 T.SK. SIEVIETES,3,110,0,0,113
 7-18(NEIESKAITOT) GADU VECUMĀ,1,444,0,0,445
 T.SK. VĪRIEŠI,1,228,0,0,229
 T.SK. SIEVIETES,0,216,0,0,216
Kopā,9,681,0,0,690
VIĻAKAS NOVADS,14,225,2,0,241
 T.SK. VĪRIEŠI,10,111,2,0,123
 T.SK. SIEVIETES,4,114,0,0,118
 7-18(NEIESKAITOT) GADU VECUMĀ,2,599,0,2,603
 T.SK. VĪRIEŠI,1,309,0,1,311
 T.SK. SIEVIETES,1,290,0,1,292
Kopā,16,824,2,2,844
VIĻĀNU NOVADS,6,342,0,0,348
 T.SK. VĪRIEŠI,4,164,0,0,168
 T.SK. SIEVIETES,2,178,0,0,180
 7-18(NEIESKAITOT) GADU VECUMĀ,0,646,0,0,646
 T.SK. VĪRIEŠI,0,304,0,0,304
 T.SK. SIEVIETES,0,342,0,0,342
Kopā,6,988,0,0,994
ZILUPES NOVADS,4,148,0,0,152
 T.SK. VĪRIEŠI,1,78,0,0,79
 T.SK. SIEVIETES,3,70,0,0,73
 7-18(NEIESKAITOT) GADU VECUMĀ,1,371,0,0,372
 T.SK. VĪRIEŠI,1,191,0,0,192
 T.SK. SIEVIETES,0,180,0,0,180
Kopā,5,519,0,0,524
