"Novads","Statuss","DzNor","DzDekl","DzReg","NavSpeka","Kopa"
"DAUGAVPILS","LATVIJAS PILSONIS",24,71524,1,1372,72921
"DAUGAVPILS","LATVIJAS PAGAIDU AIZSARDZĪBA",0,0,0,0,0
"DAUGAVPILS","LATVIJAS NEPILSONIS",6,13299,0,401,13706
"DAUGAVPILS","LATVIJAS BĒGLIS",0,0,0,0,0
"DAUGAVPILS","LATVIJAS BEZVALSTNIEKS",0,5,0,0,5
"DAUGAVPILS","LATVIJAS ALTERNATĪVAIS",0,0,0,0,0
"DAUGAVPILS","PĀRĒJIE",5,6084,2,53,6144
"JELGAVA","LATVIJAS PILSONIS",14,50183,0,1154,51351
"JELGAVA","LATVIJAS PAGAIDU AIZSARDZĪBA",0,0,0,0,0
"JELGAVA","LATVIJAS NEPILSONIS",6,7320,1,494,7821
"JELGAVA","LATVIJAS BĒGLIS",0,2,0,0,2
"JELGAVA","LATVIJAS BEZVALSTNIEKS",0,2,0,1,3
"JELGAVA","LATVIJAS ALTERNATĪVAIS",0,6,0,0,6
"JELGAVA","PĀRĒJIE",2,1923,0,54,1979
"JĒKABPILS","LATVIJAS PILSONIS",4,20100,157,618,20879
"JĒKABPILS","LATVIJAS PAGAIDU AIZSARDZĪBA",0,0,0,0,0
"JĒKABPILS","LATVIJAS NEPILSONIS",3,2149,1,122,2275
"JĒKABPILS","LATVIJAS BĒGLIS",0,0,0,0,0
"JĒKABPILS","LATVIJAS BEZVALSTNIEKS",0,2,0,0,2
"JĒKABPILS","LATVIJAS ALTERNATĪVAIS",0,0,0,0,0
"JĒKABPILS","PĀRĒJIE",0,430,1,13,444
"JŪRMALA","LATVIJAS PILSONIS",18,42623,1,920,43562
"JŪRMALA","LATVIJAS PAGAIDU AIZSARDZĪBA",0,0,0,0,0
"JŪRMALA","LATVIJAS NEPILSONIS",1,7286,0,455,7742
"JŪRMALA","LATVIJAS BĒGLIS",0,6,0,0,6
"JŪRMALA","LATVIJAS BEZVALSTNIEKS",0,5,0,0,5
"JŪRMALA","LATVIJAS ALTERNATĪVAIS",0,5,0,0,5
"JŪRMALA","PĀRĒJIE",7,5633,0,84,5724
"LIEPĀJA","LATVIJAS PILSONIS",8,58097,12,1348,59465
"LIEPĀJA","LATVIJAS PAGAIDU AIZSARDZĪBA",0,0,0,0,0
"LIEPĀJA","LATVIJAS NEPILSONIS",5,10658,1,740,11404
"LIEPĀJA","LATVIJAS BĒGLIS",0,1,0,0,1
"LIEPĀJA","LATVIJAS BEZVALSTNIEKS",0,8,0,0,8
"LIEPĀJA","LATVIJAS ALTERNATĪVAIS",0,0,0,0,0
"LIEPĀJA","PĀRĒJIE",18,5648,3,57,5726
"RĒZEKNE","LATVIJAS PILSONIS",2,27813,0,522,28337
"RĒZEKNE","LATVIJAS PAGAIDU AIZSARDZĪBA",0,0,0,0,0
"RĒZEKNE","LATVIJAS NEPILSONIS",0,1599,0,57,1656
"RĒZEKNE","LATVIJAS BĒGLIS",0,0,0,0,0
"RĒZEKNE","LATVIJAS BEZVALSTNIEKS",0,0,0,0,0
"RĒZEKNE","LATVIJAS ALTERNATĪVAIS",0,0,0,0,0
"RĒZEKNE","PĀRĒJIE",2,675,0,35,712
"RĪGA","LATVIJAS PILSONIS",167,517940,355,11398,529860
"RĪGA","LATVIJAS PAGAIDU AIZSARDZĪBA",0,0,0,0,0
"RĪGA","LATVIJAS NEPILSONIS",26,113733,228,6576,120563
"RĪGA","LATVIJAS BĒGLIS",2,62,0,17,81
"RĪGA","LATVIJAS BEZVALSTNIEKS",0,93,0,4,97
"RĪGA","LATVIJAS ALTERNATĪVAIS",0,90,0,30,120
"RĪGA","PĀRĒJIE",166,48543,15,1619,50343
"VALMIERA","LATVIJAS PILSONIS",0,23119,40,353,23512
"VALMIERA","LATVIJAS PAGAIDU AIZSARDZĪBA",0,0,0,0,0
"VALMIERA","LATVIJAS NEPILSONIS",0,1127,3,43,1173
"VALMIERA","LATVIJAS BĒGLIS",0,0,0,0,0
"VALMIERA","LATVIJAS BEZVALSTNIEKS",0,0,0,0,0
"VALMIERA","LATVIJAS ALTERNATĪVAIS",0,0,0,0,0
"VALMIERA","PĀRĒJIE",0,166,0,5,171
"VENTSPILS","LATVIJAS PILSONIS",3,29596,0,604,30203
"VENTSPILS","LATVIJAS PAGAIDU AIZSARDZĪBA",0,0,0,0,0
"VENTSPILS","LATVIJAS NEPILSONIS",0,5668,0,259,5927
"VENTSPILS","LATVIJAS BĒGLIS",0,2,0,0,2
"VENTSPILS","LATVIJAS BEZVALSTNIEKS",0,5,0,0,5
"VENTSPILS","LATVIJAS ALTERNATĪVAIS",0,0,0,0,0
"VENTSPILS","PĀRĒJIE",1,2385,0,39,2425
"AGLONAS NOVADS","LATVIJAS PILSONIS",1,3323,0,32,3356
"AGLONAS NOVADS","LATVIJAS PAGAIDU AIZSARDZĪBA",0,0,0,0,0
"AGLONAS NOVADS","LATVIJAS NEPILSONIS",1,189,0,2,192
"AGLONAS NOVADS","LATVIJAS BĒGLIS",0,0,0,0,0
"AGLONAS NOVADS","LATVIJAS BEZVALSTNIEKS",0,0,0,0,0
"AGLONAS NOVADS","LATVIJAS ALTERNATĪVAIS",0,0,0,0,0
"AGLONAS NOVADS","PĀRĒJIE",0,41,0,0,41
"AIZKRAUKLES NOVADS","LATVIJAS PILSONIS",0,7669,1,137,7807
"AIZKRAUKLES NOVADS","LATVIJAS PAGAIDU AIZSARDZĪBA",0,0,0,0,0
"AIZKRAUKLES NOVADS","LATVIJAS NEPILSONIS",0,762,0,20,782
"AIZKRAUKLES NOVADS","LATVIJAS BĒGLIS",0,0,0,0,0
"AIZKRAUKLES NOVADS","LATVIJAS BEZVALSTNIEKS",0,1,0,0,1
"AIZKRAUKLES NOVADS","LATVIJAS ALTERNATĪVAIS",0,0,0,0,0
"AIZKRAUKLES NOVADS","PĀRĒJIE",0,94,0,3,97
"AIZPUTES NOVADS","LATVIJAS PILSONIS",0,8590,1,85,8676
"AIZPUTES NOVADS","LATVIJAS PAGAIDU AIZSARDZĪBA",0,0,0,0,0
"AIZPUTES NOVADS","LATVIJAS NEPILSONIS",0,211,0,6,217
"AIZPUTES NOVADS","LATVIJAS BĒGLIS",0,0,0,0,0
"AIZPUTES NOVADS","LATVIJAS BEZVALSTNIEKS",0,0,0,0,0
"AIZPUTES NOVADS","LATVIJAS ALTERNATĪVAIS",0,0,0,0,0
"AIZPUTES NOVADS","PĀRĒJIE",0,32,0,4,36
"AKNĪSTES NOVADS","LATVIJAS PILSONIS",0,2501,1,11,2513
"AKNĪSTES NOVADS","LATVIJAS PAGAIDU AIZSARDZĪBA",0,0,0,0,0
"AKNĪSTES NOVADS","LATVIJAS NEPILSONIS",0,194,0,1,195
"AKNĪSTES NOVADS","LATVIJAS BĒGLIS",0,0,0,0,0
"AKNĪSTES NOVADS","LATVIJAS BEZVALSTNIEKS",0,0,0,0,0
"AKNĪSTES NOVADS","LATVIJAS ALTERNATĪVAIS",0,0,0,0,0
"AKNĪSTES NOVADS","PĀRĒJIE",0,17,0,0,17
"ALOJAS NOVADS","LATVIJAS PILSONIS",1,4850,0,14,4865
"ALOJAS NOVADS","LATVIJAS PAGAIDU AIZSARDZĪBA",0,0,0,0,0
"ALOJAS NOVADS","LATVIJAS NEPILSONIS",0,172,0,1,173
"ALOJAS NOVADS","LATVIJAS BĒGLIS",0,0,0,0,0
"ALOJAS NOVADS","LATVIJAS BEZVALSTNIEKS",0,0,0,0,0
"ALOJAS NOVADS","LATVIJAS ALTERNATĪVAIS",0,0,0,0,0
"ALOJAS NOVADS","PĀRĒJIE",0,10,0,0,10
"ALSUNGAS NOVADS","LATVIJAS PILSONIS",0,1400,4,6,1410
"ALSUNGAS NOVADS","LATVIJAS PAGAIDU AIZSARDZĪBA",0,0,0,0,0
"ALSUNGAS NOVADS","LATVIJAS NEPILSONIS",0,16,1,0,17
"ALSUNGAS NOVADS","LATVIJAS BĒGLIS",0,0,0,0,0
"ALSUNGAS NOVADS","LATVIJAS BEZVALSTNIEKS",0,0,0,0,0
"ALSUNGAS NOVADS","LATVIJAS ALTERNATĪVAIS",0,0,0,0,0
"ALSUNGAS NOVADS","PĀRĒJIE",0,3,0,0,3
"ALŪKSNES NOVADS","LATVIJAS PILSONIS",1,15449,8,142,15600
"ALŪKSNES NOVADS","LATVIJAS PAGAIDU AIZSARDZĪBA",0,0,0,0,0
"ALŪKSNES NOVADS","LATVIJAS NEPILSONIS",0,550,0,18,568
"ALŪKSNES NOVADS","LATVIJAS BĒGLIS",0,0,0,0,0
"ALŪKSNES NOVADS","LATVIJAS BEZVALSTNIEKS",0,1,0,0,1
"ALŪKSNES NOVADS","LATVIJAS ALTERNATĪVAIS",0,0,0,0,0
"ALŪKSNES NOVADS","PĀRĒJIE",2,162,0,10,174
"AMATAS NOVADS","LATVIJAS PILSONIS",0,5221,0,24,5245
"AMATAS NOVADS","LATVIJAS PAGAIDU AIZSARDZĪBA",0,0,0,0,0
"AMATAS NOVADS","LATVIJAS NEPILSONIS",0,187,0,2,189
"AMATAS NOVADS","LATVIJAS BĒGLIS",0,0,0,0,0
"AMATAS NOVADS","LATVIJAS BEZVALSTNIEKS",0,0,0,0,0
"AMATAS NOVADS","LATVIJAS ALTERNATĪVAIS",0,0,0,0,0
"AMATAS NOVADS","PĀRĒJIE",0,87,0,0,87
"APES NOVADS","LATVIJAS PILSONIS",1,3474,2,19,3496
"APES NOVADS","LATVIJAS PAGAIDU AIZSARDZĪBA",0,0,0,0,0
"APES NOVADS","LATVIJAS NEPILSONIS",0,107,0,0,107
"APES NOVADS","LATVIJAS BĒGLIS",0,0,0,0,0
"APES NOVADS","LATVIJAS BEZVALSTNIEKS",0,0,0,0,0
"APES NOVADS","LATVIJAS ALTERNATĪVAIS",0,0,0,0,0
"APES NOVADS","PĀRĒJIE",0,15,0,0,15
"AUCES NOVADS","LATVIJAS PILSONIS",2,6457,0,57,6516
"AUCES NOVADS","LATVIJAS PAGAIDU AIZSARDZĪBA",0,0,0,0,0
"AUCES NOVADS","LATVIJAS NEPILSONIS",0,602,0,20,622
"AUCES NOVADS","LATVIJAS BĒGLIS",0,0,0,0,0
"AUCES NOVADS","LATVIJAS BEZVALSTNIEKS",0,2,0,0,2
"AUCES NOVADS","LATVIJAS ALTERNATĪVAIS",0,0,0,0,0
"AUCES NOVADS","PĀRĒJIE",0,46,0,5,51
"ĀDAŽU NOVADS","LATVIJAS PILSONIS",2,10364,0,106,10472
"ĀDAŽU NOVADS","LATVIJAS PAGAIDU AIZSARDZĪBA",0,0,0,0,0
"ĀDAŽU NOVADS","LATVIJAS NEPILSONIS",0,744,0,27,771
"ĀDAŽU NOVADS","LATVIJAS BĒGLIS",0,0,0,0,0
"ĀDAŽU NOVADS","LATVIJAS BEZVALSTNIEKS",0,1,0,0,1
"ĀDAŽU NOVADS","LATVIJAS ALTERNATĪVAIS",0,0,0,0,0
"ĀDAŽU NOVADS","PĀRĒJIE",1,431,0,8,440
"BABĪTES NOVADS","LATVIJAS PILSONIS",0,9509,0,75,9584
"BABĪTES NOVADS","LATVIJAS PAGAIDU AIZSARDZĪBA",0,0,0,0,0
"BABĪTES NOVADS","LATVIJAS NEPILSONIS",0,725,0,15,740
"BABĪTES NOVADS","LATVIJAS BĒGLIS",0,0,0,0,0
"BABĪTES NOVADS","LATVIJAS BEZVALSTNIEKS",0,0,0,0,0
"BABĪTES NOVADS","LATVIJAS ALTERNATĪVAIS",0,0,0,0,0
"BABĪTES NOVADS","PĀRĒJIE",4,826,0,5,835
"BALDONES NOVADS","LATVIJAS PILSONIS",1,5336,0,81,5418
"BALDONES NOVADS","LATVIJAS PAGAIDU AIZSARDZĪBA",0,0,0,0,0
"BALDONES NOVADS","LATVIJAS NEPILSONIS",0,272,0,12,284
"BALDONES NOVADS","LATVIJAS BĒGLIS",0,0,0,0,0
"BALDONES NOVADS","LATVIJAS BEZVALSTNIEKS",0,0,0,0,0
"BALDONES NOVADS","LATVIJAS ALTERNATĪVAIS",0,0,0,0,0
"BALDONES NOVADS","PĀRĒJIE",0,49,0,1,50
"BALTINAVAS NOVADS","LATVIJAS PILSONIS",0,1078,0,2,1080
"BALTINAVAS NOVADS","LATVIJAS PAGAIDU AIZSARDZĪBA",0,0,0,0,0
"BALTINAVAS NOVADS","LATVIJAS NEPILSONIS",0,17,0,0,17
"BALTINAVAS NOVADS","LATVIJAS BĒGLIS",0,0,0,0,0
"BALTINAVAS NOVADS","LATVIJAS BEZVALSTNIEKS",0,0,0,0,0
"BALTINAVAS NOVADS","LATVIJAS ALTERNATĪVAIS",0,0,0,0,0
"BALTINAVAS NOVADS","PĀRĒJIE",0,8,0,2,10
"BALVU NOVADS","LATVIJAS PILSONIS",0,12567,6,99,12672
"BALVU NOVADS","LATVIJAS PAGAIDU AIZSARDZĪBA",0,0,0,0,0
"BALVU NOVADS","LATVIJAS NEPILSONIS",0,370,0,24,394
"BALVU NOVADS","LATVIJAS BĒGLIS",0,0,0,0,0
"BALVU NOVADS","LATVIJAS BEZVALSTNIEKS",0,0,0,0,0
"BALVU NOVADS","LATVIJAS ALTERNATĪVAIS",0,0,0,0,0
"BALVU NOVADS","PĀRĒJIE",0,77,0,3,80
"BAUSKAS NOVADS","LATVIJAS PILSONIS",1,22200,1,250,22452
"BAUSKAS NOVADS","LATVIJAS PAGAIDU AIZSARDZĪBA",0,0,0,0,0
"BAUSKAS NOVADS","LATVIJAS NEPILSONIS",0,1776,0,57,1833
"BAUSKAS NOVADS","LATVIJAS BĒGLIS",0,0,0,0,0
"BAUSKAS NOVADS","LATVIJAS BEZVALSTNIEKS",0,1,0,0,1
"BAUSKAS NOVADS","LATVIJAS ALTERNATĪVAIS",0,0,0,0,0
"BAUSKAS NOVADS","PĀRĒJIE",1,309,0,1,311
"BEVERĪNAS NOVADS","LATVIJAS PILSONIS",0,2997,2,20,3019
"BEVERĪNAS NOVADS","LATVIJAS PAGAIDU AIZSARDZĪBA",0,0,0,0,0
"BEVERĪNAS NOVADS","LATVIJAS NEPILSONIS",0,149,0,1,150
"BEVERĪNAS NOVADS","LATVIJAS BĒGLIS",0,0,0,0,0
"BEVERĪNAS NOVADS","LATVIJAS BEZVALSTNIEKS",0,0,0,0,0
"BEVERĪNAS NOVADS","LATVIJAS ALTERNATĪVAIS",0,0,0,0,0
"BEVERĪNAS NOVADS","PĀRĒJIE",0,18,0,0,18
"BROCĒNU NOVADS","LATVIJAS PILSONIS",0,5749,0,65,5814
"BROCĒNU NOVADS","LATVIJAS PAGAIDU AIZSARDZĪBA",0,0,0,0,0
"BROCĒNU NOVADS","LATVIJAS NEPILSONIS",0,344,0,35,379
"BROCĒNU NOVADS","LATVIJAS BĒGLIS",0,0,0,0,0
"BROCĒNU NOVADS","LATVIJAS BEZVALSTNIEKS",0,0,0,0,0
"BROCĒNU NOVADS","LATVIJAS ALTERNATĪVAIS",0,0,0,0,0
"BROCĒNU NOVADS","PĀRĒJIE",0,59,0,2,61
"BURTNIEKU NOVADS","LATVIJAS PILSONIS",17,7175,0,71,7263
"BURTNIEKU NOVADS","LATVIJAS PAGAIDU AIZSARDZĪBA",0,0,0,0,0
"BURTNIEKU NOVADS","LATVIJAS NEPILSONIS",9,383,0,15,407
"BURTNIEKU NOVADS","LATVIJAS BĒGLIS",0,0,0,0,0
"BURTNIEKU NOVADS","LATVIJAS BEZVALSTNIEKS",0,0,0,0,0
"BURTNIEKU NOVADS","LATVIJAS ALTERNATĪVAIS",0,0,0,0,0
"BURTNIEKU NOVADS","PĀRĒJIE",1,40,0,0,41
"CARNIKAVAS NOVADS","LATVIJAS PILSONIS",5,7681,0,74,7760
"CARNIKAVAS NOVADS","LATVIJAS PAGAIDU AIZSARDZĪBA",0,0,0,0,0
"CARNIKAVAS NOVADS","LATVIJAS NEPILSONIS",0,1026,0,21,1047
"CARNIKAVAS NOVADS","LATVIJAS BĒGLIS",1,1,0,0,2
"CARNIKAVAS NOVADS","LATVIJAS BEZVALSTNIEKS",0,1,0,0,1
"CARNIKAVAS NOVADS","LATVIJAS ALTERNATĪVAIS",0,0,0,0,0
"CARNIKAVAS NOVADS","PĀRĒJIE",0,365,0,33,398
"CESVAINES NOVADS","LATVIJAS PILSONIS",0,2529,7,4,2540
"CESVAINES NOVADS","LATVIJAS PAGAIDU AIZSARDZĪBA",0,0,0,0,0
"CESVAINES NOVADS","LATVIJAS NEPILSONIS",0,54,0,1,55
"CESVAINES NOVADS","LATVIJAS BĒGLIS",0,0,0,0,0
"CESVAINES NOVADS","LATVIJAS BEZVALSTNIEKS",0,0,0,0,0
"CESVAINES NOVADS","LATVIJAS ALTERNATĪVAIS",0,0,0,0,0
"CESVAINES NOVADS","PĀRĒJIE",1,5,0,0,6
"CĒSU NOVADS","LATVIJAS PILSONIS",1,16980,0,342,17323
"CĒSU NOVADS","LATVIJAS PAGAIDU AIZSARDZĪBA",0,0,0,0,0
"CĒSU NOVADS","LATVIJAS NEPILSONIS",1,652,0,55,708
"CĒSU NOVADS","LATVIJAS BĒGLIS",0,1,0,0,1
"CĒSU NOVADS","LATVIJAS BEZVALSTNIEKS",0,0,0,0,0
"CĒSU NOVADS","LATVIJAS ALTERNATĪVAIS",0,0,0,0,0
"CĒSU NOVADS","PĀRĒJIE",2,387,0,2,391
"CIBLAS NOVADS","LATVIJAS PILSONIS",1,2589,0,8,2598
"CIBLAS NOVADS","LATVIJAS PAGAIDU AIZSARDZĪBA",0,0,0,0,0
"CIBLAS NOVADS","LATVIJAS NEPILSONIS",1,123,0,6,130
"CIBLAS NOVADS","LATVIJAS BĒGLIS",0,0,0,0,0
"CIBLAS NOVADS","LATVIJAS BEZVALSTNIEKS",0,0,0,0,0
"CIBLAS NOVADS","LATVIJAS ALTERNATĪVAIS",0,0,0,0,0
"CIBLAS NOVADS","PĀRĒJIE",0,37,0,0,37
"DAGDAS NOVADS","LATVIJAS PILSONIS",2,6896,1,39,6938
"DAGDAS NOVADS","LATVIJAS PAGAIDU AIZSARDZĪBA",0,0,0,0,0
"DAGDAS NOVADS","LATVIJAS NEPILSONIS",0,542,1,6,549
"DAGDAS NOVADS","LATVIJAS BĒGLIS",0,0,0,0,0
"DAGDAS NOVADS","LATVIJAS BEZVALSTNIEKS",0,0,0,0,0
"DAGDAS NOVADS","LATVIJAS ALTERNATĪVAIS",0,0,0,0,0
"DAGDAS NOVADS","PĀRĒJIE",0,121,0,0,121
"DAUGAVPILS NOVADS","LATVIJAS PILSONIS",1,19494,3,180,19678
"DAUGAVPILS NOVADS","LATVIJAS PAGAIDU AIZSARDZĪBA",0,0,0,0,0
"DAUGAVPILS NOVADS","LATVIJAS NEPILSONIS",0,2677,0,45,2722
"DAUGAVPILS NOVADS","LATVIJAS BĒGLIS",0,0,0,0,0
"DAUGAVPILS NOVADS","LATVIJAS BEZVALSTNIEKS",0,1,0,0,1
"DAUGAVPILS NOVADS","LATVIJAS ALTERNATĪVAIS",0,0,0,0,0
"DAUGAVPILS NOVADS","PĀRĒJIE",0,832,0,3,835
"DOBELES NOVADS","LATVIJAS PILSONIS",0,18762,1,288,19051
"DOBELES NOVADS","LATVIJAS PAGAIDU AIZSARDZĪBA",0,0,0,0,0
"DOBELES NOVADS","LATVIJAS NEPILSONIS",0,1916,0,44,1960
"DOBELES NOVADS","LATVIJAS BĒGLIS",0,0,0,0,0
"DOBELES NOVADS","LATVIJAS BEZVALSTNIEKS",0,2,0,0,2
"DOBELES NOVADS","LATVIJAS ALTERNATĪVAIS",0,0,0,0,0
"DOBELES NOVADS","PĀRĒJIE",0,294,0,17,311
"DUNDAGAS NOVADS","LATVIJAS PILSONIS",2,3973,1,23,3999
"DUNDAGAS NOVADS","LATVIJAS PAGAIDU AIZSARDZĪBA",0,0,0,0,0
"DUNDAGAS NOVADS","LATVIJAS NEPILSONIS",0,56,0,0,56
"DUNDAGAS NOVADS","LATVIJAS BĒGLIS",0,0,0,0,0
"DUNDAGAS NOVADS","LATVIJAS BEZVALSTNIEKS",0,0,0,0,0
"DUNDAGAS NOVADS","LATVIJAS ALTERNATĪVAIS",0,0,0,0,0
"DUNDAGAS NOVADS","PĀRĒJIE",0,15,0,1,16
"DURBES NOVADS","LATVIJAS PILSONIS",0,2798,1,24,2823
"DURBES NOVADS","LATVIJAS PAGAIDU AIZSARDZĪBA",0,0,0,0,0
"DURBES NOVADS","LATVIJAS NEPILSONIS",0,74,0,1,75
"DURBES NOVADS","LATVIJAS BĒGLIS",0,0,0,0,0
"DURBES NOVADS","LATVIJAS BEZVALSTNIEKS",0,0,0,0,0
"DURBES NOVADS","LATVIJAS ALTERNATĪVAIS",0,0,0,0,0
"DURBES NOVADS","PĀRĒJIE",0,13,0,0,13
"ENGURES NOVADS","LATVIJAS PILSONIS",2,6991,0,48,7041
"ENGURES NOVADS","LATVIJAS PAGAIDU AIZSARDZĪBA",0,0,0,0,0
"ENGURES NOVADS","LATVIJAS NEPILSONIS",0,261,0,12,273
"ENGURES NOVADS","LATVIJAS BĒGLIS",0,1,0,0,1
"ENGURES NOVADS","LATVIJAS BEZVALSTNIEKS",0,0,0,0,0
"ENGURES NOVADS","LATVIJAS ALTERNATĪVAIS",0,0,0,0,0
"ENGURES NOVADS","PĀRĒJIE",0,121,0,5,126
"ĒRGĻU NOVADS","LATVIJAS PILSONIS",0,2900,2,17,2919
"ĒRGĻU NOVADS","LATVIJAS PAGAIDU AIZSARDZĪBA",0,0,0,0,0
"ĒRGĻU NOVADS","LATVIJAS NEPILSONIS",0,65,0,6,71
"ĒRGĻU NOVADS","LATVIJAS BĒGLIS",0,0,0,0,0
"ĒRGĻU NOVADS","LATVIJAS BEZVALSTNIEKS",0,1,0,0,1
"ĒRGĻU NOVADS","LATVIJAS ALTERNATĪVAIS",0,0,0,0,0
"ĒRGĻU NOVADS","PĀRĒJIE",0,61,0,0,61
"GARKALNES NOVADS","LATVIJAS PILSONIS",2,7543,0,41,7586
"GARKALNES NOVADS","LATVIJAS PAGAIDU AIZSARDZĪBA",0,0,0,0,0
"GARKALNES NOVADS","LATVIJAS NEPILSONIS",0,674,0,24,698
"GARKALNES NOVADS","LATVIJAS BĒGLIS",0,0,0,0,0
"GARKALNES NOVADS","LATVIJAS BEZVALSTNIEKS",0,1,0,0,1
"GARKALNES NOVADS","LATVIJAS ALTERNATĪVAIS",0,0,0,0,0
"GARKALNES NOVADS","PĀRĒJIE",0,580,0,14,594
"GROBIŅAS NOVADS","LATVIJAS PILSONIS",0,8536,2,116,8654
"GROBIŅAS NOVADS","LATVIJAS PAGAIDU AIZSARDZĪBA",0,0,0,0,0
"GROBIŅAS NOVADS","LATVIJAS NEPILSONIS",0,367,0,11,378
"GROBIŅAS NOVADS","LATVIJAS BĒGLIS",0,0,0,0,0
"GROBIŅAS NOVADS","LATVIJAS BEZVALSTNIEKS",0,0,0,0,0
"GROBIŅAS NOVADS","LATVIJAS ALTERNATĪVAIS",0,0,0,0,0
"GROBIŅAS NOVADS","PĀRĒJIE",0,145,0,1,146
"GULBENES NOVADS","LATVIJAS PILSONIS",2,20879,3,191,21075
"GULBENES NOVADS","LATVIJAS PAGAIDU AIZSARDZĪBA",0,0,0,0,0
"GULBENES NOVADS","LATVIJAS NEPILSONIS",0,704,0,23,727
"GULBENES NOVADS","LATVIJAS BĒGLIS",0,0,0,0,0
"GULBENES NOVADS","LATVIJAS BEZVALSTNIEKS",0,1,0,0,1
"GULBENES NOVADS","LATVIJAS ALTERNATĪVAIS",0,0,0,0,0
"GULBENES NOVADS","PĀRĒJIE",0,154,0,0,154
"IECAVAS NOVADS","LATVIJAS PILSONIS",0,7870,0,108,7978
"IECAVAS NOVADS","LATVIJAS PAGAIDU AIZSARDZĪBA",0,0,0,0,0
"IECAVAS NOVADS","LATVIJAS NEPILSONIS",0,847,0,29,876
"IECAVAS NOVADS","LATVIJAS BĒGLIS",0,0,0,0,0
"IECAVAS NOVADS","LATVIJAS BEZVALSTNIEKS",0,0,0,0,0
"IECAVAS NOVADS","LATVIJAS ALTERNATĪVAIS",0,0,0,0,0
"IECAVAS NOVADS","PĀRĒJIE",2,203,0,3,208
"IKŠĶILES NOVADS","LATVIJAS PILSONIS",3,9475,1,78,9557
"IKŠĶILES NOVADS","LATVIJAS PAGAIDU AIZSARDZĪBA",0,0,0,0,0
"IKŠĶILES NOVADS","LATVIJAS NEPILSONIS",0,265,0,16,281
"IKŠĶILES NOVADS","LATVIJAS BĒGLIS",0,0,0,0,0
"IKŠĶILES NOVADS","LATVIJAS BEZVALSTNIEKS",0,1,0,0,1
"IKŠĶILES NOVADS","LATVIJAS ALTERNATĪVAIS",0,0,0,0,0
"IKŠĶILES NOVADS","PĀRĒJIE",0,138,0,11,149
"ILŪKSTES NOVADS","LATVIJAS PILSONIS",0,6814,0,43,6857
"ILŪKSTES NOVADS","LATVIJAS PAGAIDU AIZSARDZĪBA",0,0,0,0,0
"ILŪKSTES NOVADS","LATVIJAS NEPILSONIS",0,535,0,4,539
"ILŪKSTES NOVADS","LATVIJAS BĒGLIS",0,0,0,0,0
"ILŪKSTES NOVADS","LATVIJAS BEZVALSTNIEKS",0,2,0,0,2
"ILŪKSTES NOVADS","LATVIJAS ALTERNATĪVAIS",0,0,0,0,0
"ILŪKSTES NOVADS","PĀRĒJIE",0,116,0,0,116
"INČUKALNA NOVADS","LATVIJAS PILSONIS",0,6514,2,138,6654
"INČUKALNA NOVADS","LATVIJAS PAGAIDU AIZSARDZĪBA",0,0,0,0,0
"INČUKALNA NOVADS","LATVIJAS NEPILSONIS",0,1119,1,53,1173
"INČUKALNA NOVADS","LATVIJAS BĒGLIS",0,0,0,0,0
"INČUKALNA NOVADS","LATVIJAS BEZVALSTNIEKS",0,0,0,0,0
"INČUKALNA NOVADS","LATVIJAS ALTERNATĪVAIS",0,0,0,0,0
"INČUKALNA NOVADS","PĀRĒJIE",2,276,0,6,284
"JAUNJELGAVAS NOVADS","LATVIJAS PILSONIS",1,5301,1,40,5343
"JAUNJELGAVAS NOVADS","LATVIJAS PAGAIDU AIZSARDZĪBA",0,0,0,0,0
"JAUNJELGAVAS NOVADS","LATVIJAS NEPILSONIS",0,322,1,43,366
"JAUNJELGAVAS NOVADS","LATVIJAS BĒGLIS",0,0,0,0,0
"JAUNJELGAVAS NOVADS","LATVIJAS BEZVALSTNIEKS",0,0,0,0,0
"JAUNJELGAVAS NOVADS","LATVIJAS ALTERNATĪVAIS",0,0,0,0,0
"JAUNJELGAVAS NOVADS","PĀRĒJIE",0,35,0,0,35
"JAUNPIEBALGAS NOVADS","LATVIJAS PILSONIS",0,2224,2,18,2244
"JAUNPIEBALGAS NOVADS","LATVIJAS PAGAIDU AIZSARDZĪBA",0,0,0,0,0
"JAUNPIEBALGAS NOVADS","LATVIJAS NEPILSONIS",0,37,0,1,38
"JAUNPIEBALGAS NOVADS","LATVIJAS BĒGLIS",0,0,0,0,0
"JAUNPIEBALGAS NOVADS","LATVIJAS BEZVALSTNIEKS",0,0,0,0,0
"JAUNPIEBALGAS NOVADS","LATVIJAS ALTERNATĪVAIS",0,0,0,0,0
"JAUNPIEBALGAS NOVADS","PĀRĒJIE",0,11,0,0,11
"JAUNPILS NOVADS","LATVIJAS PILSONIS",0,2333,0,8,2341
"JAUNPILS NOVADS","LATVIJAS PAGAIDU AIZSARDZĪBA",0,0,0,0,0
"JAUNPILS NOVADS","LATVIJAS NEPILSONIS",0,64,0,1,65
"JAUNPILS NOVADS","LATVIJAS BĒGLIS",0,0,0,0,0
"JAUNPILS NOVADS","LATVIJAS BEZVALSTNIEKS",0,0,0,0,0
"JAUNPILS NOVADS","LATVIJAS ALTERNATĪVAIS",0,0,0,0,0
"JAUNPILS NOVADS","PĀRĒJIE",0,12,0,0,12
"JELGAVAS NOVADS","LATVIJAS PILSONIS",2,20466,1,328,20797
"JELGAVAS NOVADS","LATVIJAS PAGAIDU AIZSARDZĪBA",0,0,0,0,0
"JELGAVAS NOVADS","LATVIJAS NEPILSONIS",0,2731,2,87,2820
"JELGAVAS NOVADS","LATVIJAS BĒGLIS",0,0,0,0,0
"JELGAVAS NOVADS","LATVIJAS BEZVALSTNIEKS",0,0,0,0,0
"JELGAVAS NOVADS","LATVIJAS ALTERNATĪVAIS",0,0,0,0,0
"JELGAVAS NOVADS","PĀRĒJIE",0,310,0,10,320
"JĒKABPILS NOVADS","LATVIJAS PILSONIS",0,4563,3,35,4601
"JĒKABPILS NOVADS","LATVIJAS PAGAIDU AIZSARDZĪBA",0,0,0,0,0
"JĒKABPILS NOVADS","LATVIJAS NEPILSONIS",0,121,0,4,125
"JĒKABPILS NOVADS","LATVIJAS BĒGLIS",0,0,0,0,0
"JĒKABPILS NOVADS","LATVIJAS BEZVALSTNIEKS",0,0,0,0,0
"JĒKABPILS NOVADS","LATVIJAS ALTERNATĪVAIS",0,0,0,0,0
"JĒKABPILS NOVADS","PĀRĒJIE",0,17,0,1,18
"KANDAVAS NOVADS","LATVIJAS PILSONIS",2,8122,3,97,8224
"KANDAVAS NOVADS","LATVIJAS PAGAIDU AIZSARDZĪBA",0,0,0,0,0
"KANDAVAS NOVADS","LATVIJAS NEPILSONIS",0,192,0,3,195
"KANDAVAS NOVADS","LATVIJAS BĒGLIS",0,0,0,0,0
"KANDAVAS NOVADS","LATVIJAS BEZVALSTNIEKS",0,0,0,0,0
"KANDAVAS NOVADS","LATVIJAS ALTERNATĪVAIS",0,0,0,0,0
"KANDAVAS NOVADS","PĀRĒJIE",0,52,0,2,54
"KĀRSAVAS NOVADS","LATVIJAS PILSONIS",2,5475,0,34,5511
"KĀRSAVAS NOVADS","LATVIJAS PAGAIDU AIZSARDZĪBA",0,0,0,0,0
"KĀRSAVAS NOVADS","LATVIJAS NEPILSONIS",0,221,0,7,228
"KĀRSAVAS NOVADS","LATVIJAS BĒGLIS",0,0,0,0,0
"KĀRSAVAS NOVADS","LATVIJAS BEZVALSTNIEKS",0,0,0,0,0
"KĀRSAVAS NOVADS","LATVIJAS ALTERNATĪVAIS",0,0,0,0,0
"KĀRSAVAS NOVADS","PĀRĒJIE",0,55,0,0,55
"KOCĒNU NOVADS","LATVIJAS PILSONIS",0,5896,6,55,5957
"KOCĒNU NOVADS","LATVIJAS PAGAIDU AIZSARDZĪBA",0,0,0,0,0
"KOCĒNU NOVADS","LATVIJAS NEPILSONIS",0,317,0,10,327
"KOCĒNU NOVADS","LATVIJAS BĒGLIS",0,0,0,0,0
"KOCĒNU NOVADS","LATVIJAS BEZVALSTNIEKS",0,0,0,0,0
"KOCĒNU NOVADS","LATVIJAS ALTERNATĪVAIS",0,0,0,0,0
"KOCĒNU NOVADS","PĀRĒJIE",0,21,0,1,22
"KOKNESES NOVADS","LATVIJAS PILSONIS",1,5148,0,59,5208
"KOKNESES NOVADS","LATVIJAS PAGAIDU AIZSARDZĪBA",0,0,0,0,0
"KOKNESES NOVADS","LATVIJAS NEPILSONIS",0,153,0,19,172
"KOKNESES NOVADS","LATVIJAS BĒGLIS",0,0,0,0,0
"KOKNESES NOVADS","LATVIJAS BEZVALSTNIEKS",0,1,0,0,1
"KOKNESES NOVADS","LATVIJAS ALTERNATĪVAIS",0,0,0,0,0
"KOKNESES NOVADS","PĀRĒJIE",0,26,0,1,27
"KRĀSLAVAS NOVADS","LATVIJAS PILSONIS",4,13649,9,195,13857
"KRĀSLAVAS NOVADS","LATVIJAS PAGAIDU AIZSARDZĪBA",0,0,0,0,0
"KRĀSLAVAS NOVADS","LATVIJAS NEPILSONIS",0,1898,0,64,1962
"KRĀSLAVAS NOVADS","LATVIJAS BĒGLIS",0,0,0,0,0
"KRĀSLAVAS NOVADS","LATVIJAS BEZVALSTNIEKS",0,1,0,0,1
"KRĀSLAVAS NOVADS","LATVIJAS ALTERNATĪVAIS",0,0,0,0,0
"KRĀSLAVAS NOVADS","PĀRĒJIE",0,555,0,10,565
"KRIMULDAS NOVADS","LATVIJAS PILSONIS",1,5027,1,20,5049
"KRIMULDAS NOVADS","LATVIJAS PAGAIDU AIZSARDZĪBA",0,0,0,0,0
"KRIMULDAS NOVADS","LATVIJAS NEPILSONIS",0,112,0,2,114
"KRIMULDAS NOVADS","LATVIJAS BĒGLIS",0,0,0,0,0
"KRIMULDAS NOVADS","LATVIJAS BEZVALSTNIEKS",0,1,0,0,1
"KRIMULDAS NOVADS","LATVIJAS ALTERNATĪVAIS",0,0,0,0,0
"KRIMULDAS NOVADS","PĀRĒJIE",1,29,0,0,30
"KRUSTPILS NOVADS","LATVIJAS PILSONIS",0,5585,0,40,5625
"KRUSTPILS NOVADS","LATVIJAS PAGAIDU AIZSARDZĪBA",0,0,0,0,0
"KRUSTPILS NOVADS","LATVIJAS NEPILSONIS",0,371,0,7,378
"KRUSTPILS NOVADS","LATVIJAS BĒGLIS",0,0,0,0,0
"KRUSTPILS NOVADS","LATVIJAS BEZVALSTNIEKS",0,2,0,0,2
"KRUSTPILS NOVADS","LATVIJAS ALTERNATĪVAIS",0,0,0,0,0
"KRUSTPILS NOVADS","PĀRĒJIE",0,47,0,0,47
"KULDĪGAS NOVADS","LATVIJAS PILSONIS",0,23204,1,425,23630
"KULDĪGAS NOVADS","LATVIJAS PAGAIDU AIZSARDZĪBA",0,0,0,0,0
"KULDĪGAS NOVADS","LATVIJAS NEPILSONIS",0,446,0,22,468
"KULDĪGAS NOVADS","LATVIJAS BĒGLIS",0,0,0,0,0
"KULDĪGAS NOVADS","LATVIJAS BEZVALSTNIEKS",0,1,0,0,1
"KULDĪGAS NOVADS","LATVIJAS ALTERNATĪVAIS",0,0,0,0,0
"KULDĪGAS NOVADS","PĀRĒJIE",0,97,0,4,101
"ĶEGUMA NOVADS","LATVIJAS PILSONIS",1,5325,3,70,5399
"ĶEGUMA NOVADS","LATVIJAS PAGAIDU AIZSARDZĪBA",0,0,0,0,0
"ĶEGUMA NOVADS","LATVIJAS NEPILSONIS",0,291,0,9,300
"ĶEGUMA NOVADS","LATVIJAS BĒGLIS",0,0,0,0,0
"ĶEGUMA NOVADS","LATVIJAS BEZVALSTNIEKS",0,0,0,0,0
"ĶEGUMA NOVADS","LATVIJAS ALTERNATĪVAIS",0,0,0,0,0
"ĶEGUMA NOVADS","PĀRĒJIE",0,74,0,1,75
"ĶEKAVAS NOVADS","LATVIJAS PILSONIS",3,21319,3,172,21497
"ĶEKAVAS NOVADS","LATVIJAS PAGAIDU AIZSARDZĪBA",0,0,0,0,0
"ĶEKAVAS NOVADS","LATVIJAS NEPILSONIS",1,1538,0,66,1605
"ĶEKAVAS NOVADS","LATVIJAS BĒGLIS",0,5,0,0,5
"ĶEKAVAS NOVADS","LATVIJAS BEZVALSTNIEKS",0,2,0,0,2
"ĶEKAVAS NOVADS","LATVIJAS ALTERNATĪVAIS",0,0,0,0,0
"ĶEKAVAS NOVADS","PĀRĒJIE",4,589,0,14,607
"LIELVĀRDES NOVADS","LATVIJAS PILSONIS",1,9641,2,152,9796
"LIELVĀRDES NOVADS","LATVIJAS PAGAIDU AIZSARDZĪBA",0,0,0,0,0
"LIELVĀRDES NOVADS","LATVIJAS NEPILSONIS",0,432,0,35,467
"LIELVĀRDES NOVADS","LATVIJAS BĒGLIS",0,0,0,0,0
"LIELVĀRDES NOVADS","LATVIJAS BEZVALSTNIEKS",0,1,0,0,1
"LIELVĀRDES NOVADS","LATVIJAS ALTERNATĪVAIS",0,0,0,0,0
"LIELVĀRDES NOVADS","PĀRĒJIE",0,146,0,7,153
"LIMBAŽU NOVADS","LATVIJAS PILSONIS",2,16682,2,109,16795
"LIMBAŽU NOVADS","LATVIJAS PAGAIDU AIZSARDZĪBA",0,0,0,0,0
"LIMBAŽU NOVADS","LATVIJAS NEPILSONIS",0,506,0,18,524
"LIMBAŽU NOVADS","LATVIJAS BĒGLIS",0,0,0,0,0
"LIMBAŽU NOVADS","LATVIJAS BEZVALSTNIEKS",0,1,0,0,1
"LIMBAŽU NOVADS","LATVIJAS ALTERNATĪVAIS",0,0,0,0,0
"LIMBAŽU NOVADS","PĀRĒJIE",1,145,0,2,148
"LĪGATNES NOVADS","LATVIJAS PILSONIS",0,3300,0,42,3342
"LĪGATNES NOVADS","LATVIJAS PAGAIDU AIZSARDZĪBA",0,0,0,0,0
"LĪGATNES NOVADS","LATVIJAS NEPILSONIS",0,116,0,3,119
"LĪGATNES NOVADS","LATVIJAS BĒGLIS",0,0,0,0,0
"LĪGATNES NOVADS","LATVIJAS BEZVALSTNIEKS",0,0,0,0,0
"LĪGATNES NOVADS","LATVIJAS ALTERNATĪVAIS",0,0,0,0,0
"LĪGATNES NOVADS","PĀRĒJIE",0,45,0,1,46
"LĪVĀNU NOVADS","LATVIJAS PILSONIS",2,11229,1,137,11369
"LĪVĀNU NOVADS","LATVIJAS PAGAIDU AIZSARDZĪBA",0,0,0,0,0
"LĪVĀNU NOVADS","LATVIJAS NEPILSONIS",0,554,0,25,579
"LĪVĀNU NOVADS","LATVIJAS BĒGLIS",0,0,0,0,0
"LĪVĀNU NOVADS","LATVIJAS BEZVALSTNIEKS",0,0,0,0,0
"LĪVĀNU NOVADS","LATVIJAS ALTERNATĪVAIS",0,0,0,1,1
"LĪVĀNU NOVADS","PĀRĒJIE",0,236,0,8,244
"LUBĀNAS NOVADS","LATVIJAS PILSONIS",0,2394,0,6,2400
"LUBĀNAS NOVADS","LATVIJAS PAGAIDU AIZSARDZĪBA",0,0,0,0,0
"LUBĀNAS NOVADS","LATVIJAS NEPILSONIS",0,23,0,0,23
"LUBĀNAS NOVADS","LATVIJAS BĒGLIS",0,0,0,0,0
"LUBĀNAS NOVADS","LATVIJAS BEZVALSTNIEKS",0,0,0,0,0
"LUBĀNAS NOVADS","LATVIJAS ALTERNATĪVAIS",0,0,0,0,0
"LUBĀNAS NOVADS","PĀRĒJIE",0,6,0,0,6
"LUDZAS NOVADS","LATVIJAS PILSONIS",2,12150,1,138,12291
"LUDZAS NOVADS","LATVIJAS PAGAIDU AIZSARDZĪBA",0,0,0,0,0
"LUDZAS NOVADS","LATVIJAS NEPILSONIS",0,785,0,27,812
"LUDZAS NOVADS","LATVIJAS BĒGLIS",0,0,0,0,0
"LUDZAS NOVADS","LATVIJAS BEZVALSTNIEKS",0,0,0,0,0
"LUDZAS NOVADS","LATVIJAS ALTERNATĪVAIS",0,0,0,0,0
"LUDZAS NOVADS","PĀRĒJIE",0,227,0,5,232
"MADONAS NOVADS","LATVIJAS PILSONIS",1,23240,4,246,23491
"MADONAS NOVADS","LATVIJAS PAGAIDU AIZSARDZĪBA",0,0,0,0,0
"MADONAS NOVADS","LATVIJAS NEPILSONIS",0,767,1,42,810
"MADONAS NOVADS","LATVIJAS BĒGLIS",0,0,0,0,0
"MADONAS NOVADS","LATVIJAS BEZVALSTNIEKS",0,0,0,0,0
"MADONAS NOVADS","LATVIJAS ALTERNATĪVAIS",0,0,0,0,0
"MADONAS NOVADS","PĀRĒJIE",0,148,1,2,151
"MAZSALACAS NOVADS","LATVIJAS PILSONIS",0,3116,7,27,3150
"MAZSALACAS NOVADS","LATVIJAS PAGAIDU AIZSARDZĪBA",0,0,0,0,0
"MAZSALACAS NOVADS","LATVIJAS NEPILSONIS",0,107,0,2,109
"MAZSALACAS NOVADS","LATVIJAS BĒGLIS",0,0,0,0,0
"MAZSALACAS NOVADS","LATVIJAS BEZVALSTNIEKS",0,0,0,0,0
"MAZSALACAS NOVADS","LATVIJAS ALTERNATĪVAIS",0,0,0,0,0
"MAZSALACAS NOVADS","PĀRĒJIE",0,8,0,0,8
"MĀLPILS NOVADS","LATVIJAS PILSONIS",0,3358,0,22,3380
"MĀLPILS NOVADS","LATVIJAS PAGAIDU AIZSARDZĪBA",0,0,0,0,0
"MĀLPILS NOVADS","LATVIJAS NEPILSONIS",0,196,0,3,199
"MĀLPILS NOVADS","LATVIJAS BĒGLIS",0,0,0,0,0
"MĀLPILS NOVADS","LATVIJAS BEZVALSTNIEKS",0,0,0,0,0
"MĀLPILS NOVADS","LATVIJAS ALTERNATĪVAIS",0,0,0,0,0
"MĀLPILS NOVADS","PĀRĒJIE",0,23,0,0,23
"MĀRUPES NOVADS","LATVIJAS PILSONIS",4,17920,2,142,18068
"MĀRUPES NOVADS","LATVIJAS PAGAIDU AIZSARDZĪBA",0,0,0,0,0
"MĀRUPES NOVADS","LATVIJAS NEPILSONIS",0,1126,0,39,1165
"MĀRUPES NOVADS","LATVIJAS BĒGLIS",0,1,0,0,1
"MĀRUPES NOVADS","LATVIJAS BEZVALSTNIEKS",0,1,0,0,1
"MĀRUPES NOVADS","LATVIJAS ALTERNATĪVAIS",0,0,0,0,0
"MĀRUPES NOVADS","PĀRĒJIE",10,1954,1,29,1994
"MĒRSRAGA NOVADS","LATVIJAS PILSONIS",1,1565,0,12,1578
"MĒRSRAGA NOVADS","LATVIJAS PAGAIDU AIZSARDZĪBA",0,0,0,0,0
"MĒRSRAGA NOVADS","LATVIJAS NEPILSONIS",0,31,0,3,34
"MĒRSRAGA NOVADS","LATVIJAS BĒGLIS",0,0,0,0,0
"MĒRSRAGA NOVADS","LATVIJAS BEZVALSTNIEKS",0,0,0,0,0
"MĒRSRAGA NOVADS","LATVIJAS ALTERNATĪVAIS",0,0,0,0,0
"MĒRSRAGA NOVADS","PĀRĒJIE",0,9,0,1,10
"NAUKŠĒNU NOVADS","LATVIJAS PILSONIS",0,1818,0,24,1842
"NAUKŠĒNU NOVADS","LATVIJAS PAGAIDU AIZSARDZĪBA",0,0,0,0,0
"NAUKŠĒNU NOVADS","LATVIJAS NEPILSONIS",0,30,0,1,31
"NAUKŠĒNU NOVADS","LATVIJAS BĒGLIS",0,0,0,0,0
"NAUKŠĒNU NOVADS","LATVIJAS BEZVALSTNIEKS",0,0,0,0,0
"NAUKŠĒNU NOVADS","LATVIJAS ALTERNATĪVAIS",0,0,0,0,0
"NAUKŠĒNU NOVADS","PĀRĒJIE",0,2,0,0,2
"NERETAS NOVADS","LATVIJAS PILSONIS",0,3317,0,20,3337
"NERETAS NOVADS","LATVIJAS PAGAIDU AIZSARDZĪBA",0,0,0,0,0
"NERETAS NOVADS","LATVIJAS NEPILSONIS",0,248,0,15,263
"NERETAS NOVADS","LATVIJAS BĒGLIS",0,0,0,0,0
"NERETAS NOVADS","LATVIJAS BEZVALSTNIEKS",0,0,0,0,0
"NERETAS NOVADS","LATVIJAS ALTERNATĪVAIS",0,0,0,0,0
"NERETAS NOVADS","PĀRĒJIE",0,28,0,0,28
"NĪCAS NOVADS","LATVIJAS PILSONIS",0,3273,0,22,3295
"NĪCAS NOVADS","LATVIJAS PAGAIDU AIZSARDZĪBA",0,0,0,0,0
"NĪCAS NOVADS","LATVIJAS NEPILSONIS",0,53,0,4,57
"NĪCAS NOVADS","LATVIJAS BĒGLIS",0,0,0,0,0
"NĪCAS NOVADS","LATVIJAS BEZVALSTNIEKS",0,0,0,0,0
"NĪCAS NOVADS","LATVIJAS ALTERNATĪVAIS",0,0,0,0,0
"NĪCAS NOVADS","PĀRĒJIE",0,32,0,0,32
"OGRES NOVADS","LATVIJAS PILSONIS",3,31788,0,528,32319
"OGRES NOVADS","LATVIJAS PAGAIDU AIZSARDZĪBA",0,0,0,0,0
"OGRES NOVADS","LATVIJAS NEPILSONIS",0,2313,0,157,2470
"OGRES NOVADS","LATVIJAS BĒGLIS",0,0,0,0,0
"OGRES NOVADS","LATVIJAS BEZVALSTNIEKS",0,2,0,0,2
"OGRES NOVADS","LATVIJAS ALTERNATĪVAIS",0,0,0,0,0
"OGRES NOVADS","PĀRĒJIE",23,519,0,24,566
"OLAINES NOVADS","LATVIJAS PILSONIS",4,14794,2,280,15080
"OLAINES NOVADS","LATVIJAS PAGAIDU AIZSARDZĪBA",0,0,0,0,0
"OLAINES NOVADS","LATVIJAS NEPILSONIS",1,4044,1,191,4237
"OLAINES NOVADS","LATVIJAS BĒGLIS",0,0,0,0,0
"OLAINES NOVADS","LATVIJAS BEZVALSTNIEKS",0,2,0,0,2
"OLAINES NOVADS","LATVIJAS ALTERNATĪVAIS",0,0,0,0,0
"OLAINES NOVADS","PĀRĒJIE",1,842,0,14,857
"OZOLNIEKU NOVADS","LATVIJAS PILSONIS",0,9088,0,121,9209
"OZOLNIEKU NOVADS","LATVIJAS PAGAIDU AIZSARDZĪBA",0,0,0,0,0
"OZOLNIEKU NOVADS","LATVIJAS NEPILSONIS",0,826,0,46,872
"OZOLNIEKU NOVADS","LATVIJAS BĒGLIS",0,0,0,0,0
"OZOLNIEKU NOVADS","LATVIJAS BEZVALSTNIEKS",0,0,0,0,0
"OZOLNIEKU NOVADS","LATVIJAS ALTERNATĪVAIS",0,0,0,0,0
"OZOLNIEKU NOVADS","PĀRĒJIE",1,534,0,2,537
"PĀRGAUJAS NOVADS","LATVIJAS PILSONIS",0,3831,0,12,3843
"PĀRGAUJAS NOVADS","LATVIJAS PAGAIDU AIZSARDZĪBA",0,0,0,0,0
"PĀRGAUJAS NOVADS","LATVIJAS NEPILSONIS",0,77,0,8,85
"PĀRGAUJAS NOVADS","LATVIJAS BĒGLIS",0,0,0,0,0
"PĀRGAUJAS NOVADS","LATVIJAS BEZVALSTNIEKS",0,0,0,0,0
"PĀRGAUJAS NOVADS","LATVIJAS ALTERNATĪVAIS",0,0,0,0,0
"PĀRGAUJAS NOVADS","PĀRĒJIE",0,18,0,0,18
"PĀVILOSTAS NOVADS","LATVIJAS PILSONIS",0,2693,0,9,2702
"PĀVILOSTAS NOVADS","LATVIJAS PAGAIDU AIZSARDZĪBA",0,0,0,0,0
"PĀVILOSTAS NOVADS","LATVIJAS NEPILSONIS",0,83,0,1,84
"PĀVILOSTAS NOVADS","LATVIJAS BĒGLIS",0,0,0,0,0
"PĀVILOSTAS NOVADS","LATVIJAS BEZVALSTNIEKS",0,0,0,0,0
"PĀVILOSTAS NOVADS","LATVIJAS ALTERNATĪVAIS",0,0,0,0,0
"PĀVILOSTAS NOVADS","PĀRĒJIE",0,25,0,0,25
"PĻAVIŅU NOVADS","LATVIJAS PILSONIS",0,4830,5,90,4925
"PĻAVIŅU NOVADS","LATVIJAS PAGAIDU AIZSARDZĪBA",0,0,0,0,0
"PĻAVIŅU NOVADS","LATVIJAS NEPILSONIS",0,377,0,16,393
"PĻAVIŅU NOVADS","LATVIJAS BĒGLIS",0,0,0,0,0
"PĻAVIŅU NOVADS","LATVIJAS BEZVALSTNIEKS",0,0,0,0,0
"PĻAVIŅU NOVADS","LATVIJAS ALTERNATĪVAIS",0,0,0,0,0
"PĻAVIŅU NOVADS","PĀRĒJIE",0,51,1,1,53
"PREIĻU NOVADS","LATVIJAS PILSONIS",1,9563,0,95,9659
"PREIĻU NOVADS","LATVIJAS PAGAIDU AIZSARDZĪBA",0,0,0,0,0
"PREIĻU NOVADS","LATVIJAS NEPILSONIS",0,262,0,14,276
"PREIĻU NOVADS","LATVIJAS BĒGLIS",0,0,0,0,0
"PREIĻU NOVADS","LATVIJAS BEZVALSTNIEKS",0,0,0,0,0
"PREIĻU NOVADS","LATVIJAS ALTERNATĪVAIS",0,0,0,0,0
"PREIĻU NOVADS","PĀRĒJIE",0,90,0,0,90
"PRIEKULES NOVADS","LATVIJAS PILSONIS",0,5096,0,34,5130
"PRIEKULES NOVADS","LATVIJAS PAGAIDU AIZSARDZĪBA",0,0,0,0,0
"PRIEKULES NOVADS","LATVIJAS NEPILSONIS",0,390,0,10,400
"PRIEKULES NOVADS","LATVIJAS BĒGLIS",0,0,0,0,0
"PRIEKULES NOVADS","LATVIJAS BEZVALSTNIEKS",0,1,0,0,1
"PRIEKULES NOVADS","LATVIJAS ALTERNATĪVAIS",0,0,0,0,0
"PRIEKULES NOVADS","PĀRĒJIE",1,64,0,1,66
"PRIEKUĻU NOVADS","LATVIJAS PILSONIS",0,7634,1,117,7752
"PRIEKUĻU NOVADS","LATVIJAS PAGAIDU AIZSARDZĪBA",0,0,0,0,0
"PRIEKUĻU NOVADS","LATVIJAS NEPILSONIS",0,564,0,38,602
"PRIEKUĻU NOVADS","LATVIJAS BĒGLIS",0,0,0,0,0
"PRIEKUĻU NOVADS","LATVIJAS BEZVALSTNIEKS",0,0,0,0,0
"PRIEKUĻU NOVADS","LATVIJAS ALTERNATĪVAIS",0,0,0,0,0
"PRIEKUĻU NOVADS","PĀRĒJIE",0,98,0,1,99
"RAUNAS NOVADS","LATVIJAS PILSONIS",0,3122,0,34,3156
"RAUNAS NOVADS","LATVIJAS PAGAIDU AIZSARDZĪBA",0,0,0,0,0
"RAUNAS NOVADS","LATVIJAS NEPILSONIS",0,109,0,1,110
"RAUNAS NOVADS","LATVIJAS BĒGLIS",0,0,0,0,0
"RAUNAS NOVADS","LATVIJAS BEZVALSTNIEKS",0,0,0,0,0
"RAUNAS NOVADS","LATVIJAS ALTERNATĪVAIS",0,0,0,0,0
"RAUNAS NOVADS","PĀRĒJIE",0,3,0,0,3
"RĒZEKNES NOVADS","LATVIJAS PILSONIS",8,26094,3,157,26262
"RĒZEKNES NOVADS","LATVIJAS PAGAIDU AIZSARDZĪBA",0,0,0,0,0
"RĒZEKNES NOVADS","LATVIJAS NEPILSONIS",0,939,0,22,961
"RĒZEKNES NOVADS","LATVIJAS BĒGLIS",0,0,0,0,0
"RĒZEKNES NOVADS","LATVIJAS BEZVALSTNIEKS",0,1,0,0,1
"RĒZEKNES NOVADS","LATVIJAS ALTERNATĪVAIS",0,0,0,0,0
"RĒZEKNES NOVADS","PĀRĒJIE",1,275,0,0,276
"RIEBIŅU NOVADS","LATVIJAS PILSONIS",9,5016,0,31,5056
"RIEBIŅU NOVADS","LATVIJAS PAGAIDU AIZSARDZĪBA",0,0,0,0,0
"RIEBIŅU NOVADS","LATVIJAS NEPILSONIS",0,139,0,2,141
"RIEBIŅU NOVADS","LATVIJAS BĒGLIS",0,0,0,0,0
"RIEBIŅU NOVADS","LATVIJAS BEZVALSTNIEKS",0,0,0,0,0
"RIEBIŅU NOVADS","LATVIJAS ALTERNATĪVAIS",0,0,0,0,0
"RIEBIŅU NOVADS","PĀRĒJIE",0,39,0,0,39
"ROJAS NOVADS","LATVIJAS PILSONIS",0,3687,0,50,3737
"ROJAS NOVADS","LATVIJAS PAGAIDU AIZSARDZĪBA",0,0,0,0,0
"ROJAS NOVADS","LATVIJAS NEPILSONIS",0,50,0,1,51
"ROJAS NOVADS","LATVIJAS BĒGLIS",0,0,0,0,0
"ROJAS NOVADS","LATVIJAS BEZVALSTNIEKS",0,0,0,0,0
"ROJAS NOVADS","LATVIJAS ALTERNATĪVAIS",0,0,0,0,0
"ROJAS NOVADS","PĀRĒJIE",0,66,0,12,78
"ROPAŽU NOVADS","LATVIJAS PILSONIS",0,6128,1,87,6216
"ROPAŽU NOVADS","LATVIJAS PAGAIDU AIZSARDZĪBA",0,0,0,0,0
"ROPAŽU NOVADS","LATVIJAS NEPILSONIS",0,645,0,34,679
"ROPAŽU NOVADS","LATVIJAS BĒGLIS",30,0,0,0,30
"ROPAŽU NOVADS","LATVIJAS BEZVALSTNIEKS",0,2,0,0,2
"ROPAŽU NOVADS","LATVIJAS ALTERNATĪVAIS",342,2,0,8,352
"ROPAŽU NOVADS","PĀRĒJIE",6,147,0,4,157
"RUCAVAS NOVADS","LATVIJAS PILSONIS",0,1616,0,3,1619
"RUCAVAS NOVADS","LATVIJAS PAGAIDU AIZSARDZĪBA",0,0,0,0,0
"RUCAVAS NOVADS","LATVIJAS NEPILSONIS",0,40,0,4,44
"RUCAVAS NOVADS","LATVIJAS BĒGLIS",0,0,0,0,0
"RUCAVAS NOVADS","LATVIJAS BEZVALSTNIEKS",0,0,0,0,0
"RUCAVAS NOVADS","LATVIJAS ALTERNATĪVAIS",0,0,0,0,0
"RUCAVAS NOVADS","PĀRĒJIE",0,24,0,0,24
"RUGĀJU NOVADS","LATVIJAS PILSONIS",1,2199,0,3,2203
"RUGĀJU NOVADS","LATVIJAS PAGAIDU AIZSARDZĪBA",0,0,0,0,0
"RUGĀJU NOVADS","LATVIJAS NEPILSONIS",0,34,0,0,34
"RUGĀJU NOVADS","LATVIJAS BĒGLIS",0,0,0,0,0
"RUGĀJU NOVADS","LATVIJAS BEZVALSTNIEKS",0,0,0,0,0
"RUGĀJU NOVADS","LATVIJAS ALTERNATĪVAIS",0,0,0,0,0
"RUGĀJU NOVADS","PĀRĒJIE",0,6,0,0,6
"RUNDĀLES NOVADS","LATVIJAS PILSONIS",1,3223,0,31,3255
"RUNDĀLES NOVADS","LATVIJAS PAGAIDU AIZSARDZĪBA",0,0,0,0,0
"RUNDĀLES NOVADS","LATVIJAS NEPILSONIS",0,457,0,13,470
"RUNDĀLES NOVADS","LATVIJAS BĒGLIS",0,0,0,0,0
"RUNDĀLES NOVADS","LATVIJAS BEZVALSTNIEKS",0,1,0,0,1
"RUNDĀLES NOVADS","LATVIJAS ALTERNATĪVAIS",0,0,0,0,0
"RUNDĀLES NOVADS","PĀRĒJIE",1,28,0,0,29
"RŪJIENAS NOVADS","LATVIJAS PILSONIS",1,5047,0,16,5064
"RŪJIENAS NOVADS","LATVIJAS PAGAIDU AIZSARDZĪBA",0,0,0,0,0
"RŪJIENAS NOVADS","LATVIJAS NEPILSONIS",0,148,0,2,150
"RŪJIENAS NOVADS","LATVIJAS BĒGLIS",0,0,0,0,0
"RŪJIENAS NOVADS","LATVIJAS BEZVALSTNIEKS",0,0,0,0,0
"RŪJIENAS NOVADS","LATVIJAS ALTERNATĪVAIS",0,0,0,0,0
"RŪJIENAS NOVADS","PĀRĒJIE",0,14,0,0,14
"SALACGRĪVAS NOVADS","LATVIJAS PILSONIS",0,7681,7,52,7740
"SALACGRĪVAS NOVADS","LATVIJAS PAGAIDU AIZSARDZĪBA",0,0,0,0,0
"SALACGRĪVAS NOVADS","LATVIJAS NEPILSONIS",0,224,0,10,234
"SALACGRĪVAS NOVADS","LATVIJAS BĒGLIS",0,0,0,0,0
"SALACGRĪVAS NOVADS","LATVIJAS BEZVALSTNIEKS",0,0,0,0,0
"SALACGRĪVAS NOVADS","LATVIJAS ALTERNATĪVAIS",0,0,0,0,0
"SALACGRĪVAS NOVADS","PĀRĒJIE",0,50,0,0,50
"SALAS NOVADS","LATVIJAS PILSONIS",1,3451,1,33,3486
"SALAS NOVADS","LATVIJAS PAGAIDU AIZSARDZĪBA",0,0,0,0,0
"SALAS NOVADS","LATVIJAS NEPILSONIS",0,221,0,12,233
"SALAS NOVADS","LATVIJAS BĒGLIS",0,0,0,0,0
"SALAS NOVADS","LATVIJAS BEZVALSTNIEKS",0,0,0,0,0
"SALAS NOVADS","LATVIJAS ALTERNATĪVAIS",0,0,0,0,0
"SALAS NOVADS","PĀRĒJIE",0,22,0,0,22
"SALASPILS NOVADS","LATVIJAS PILSONIS",3,18207,2,202,18414
"SALASPILS NOVADS","LATVIJAS PAGAIDU AIZSARDZĪBA",0,0,0,0,0
"SALASPILS NOVADS","LATVIJAS NEPILSONIS",0,4257,0,161,4418
"SALASPILS NOVADS","LATVIJAS BĒGLIS",0,0,0,0,0
"SALASPILS NOVADS","LATVIJAS BEZVALSTNIEKS",0,1,0,0,1
"SALASPILS NOVADS","LATVIJAS ALTERNATĪVAIS",0,0,0,0,0
"SALASPILS NOVADS","PĀRĒJIE",0,867,0,7,874
"SALDUS NOVADS","LATVIJAS PILSONIS",0,23371,1,352,23724
"SALDUS NOVADS","LATVIJAS PAGAIDU AIZSARDZĪBA",0,0,0,0,0
"SALDUS NOVADS","LATVIJAS NEPILSONIS",0,824,0,39,863
"SALDUS NOVADS","LATVIJAS BĒGLIS",0,0,0,0,0
"SALDUS NOVADS","LATVIJAS BEZVALSTNIEKS",0,0,0,0,0
"SALDUS NOVADS","LATVIJAS ALTERNATĪVAIS",0,0,0,0,0
"SALDUS NOVADS","PĀRĒJIE",3,164,0,6,173
"SAULKRASTU NOVADS","LATVIJAS PILSONIS",2,5612,2,56,5672
"SAULKRASTU NOVADS","LATVIJAS PAGAIDU AIZSARDZĪBA",0,0,0,0,0
"SAULKRASTU NOVADS","LATVIJAS NEPILSONIS",0,294,0,13,307
"SAULKRASTU NOVADS","LATVIJAS BĒGLIS",0,0,0,0,0
"SAULKRASTU NOVADS","LATVIJAS BEZVALSTNIEKS",0,1,0,0,1
"SAULKRASTU NOVADS","LATVIJAS ALTERNATĪVAIS",0,0,0,0,0
"SAULKRASTU NOVADS","PĀRĒJIE",1,302,0,2,305
"SĒJAS NOVADS","LATVIJAS PILSONIS",2,2225,0,11,2238
"SĒJAS NOVADS","LATVIJAS PAGAIDU AIZSARDZĪBA",0,0,0,0,0
"SĒJAS NOVADS","LATVIJAS NEPILSONIS",0,90,0,2,92
"SĒJAS NOVADS","LATVIJAS BĒGLIS",0,0,0,0,0
"SĒJAS NOVADS","LATVIJAS BEZVALSTNIEKS",0,0,0,0,0
"SĒJAS NOVADS","LATVIJAS ALTERNATĪVAIS",0,0,0,0,0
"SĒJAS NOVADS","PĀRĒJIE",0,22,0,0,22
"SIGULDAS NOVADS","LATVIJAS PILSONIS",6,17506,0,140,17652
"SIGULDAS NOVADS","LATVIJAS PAGAIDU AIZSARDZĪBA",0,0,0,0,0
"SIGULDAS NOVADS","LATVIJAS NEPILSONIS",0,533,0,26,559
"SIGULDAS NOVADS","LATVIJAS BĒGLIS",0,0,0,0,0
"SIGULDAS NOVADS","LATVIJAS BEZVALSTNIEKS",0,1,0,0,1
"SIGULDAS NOVADS","LATVIJAS ALTERNATĪVAIS",0,0,0,0,0
"SIGULDAS NOVADS","PĀRĒJIE",0,169,0,9,178
"SKRĪVERU NOVADS","LATVIJAS PILSONIS",0,3426,0,28,3454
"SKRĪVERU NOVADS","LATVIJAS PAGAIDU AIZSARDZĪBA",0,0,0,0,0
"SKRĪVERU NOVADS","LATVIJAS NEPILSONIS",0,92,0,17,109
"SKRĪVERU NOVADS","LATVIJAS BĒGLIS",0,0,0,0,0
"SKRĪVERU NOVADS","LATVIJAS BEZVALSTNIEKS",0,0,0,0,0
"SKRĪVERU NOVADS","LATVIJAS ALTERNATĪVAIS",0,0,0,0,0
"SKRĪVERU NOVADS","PĀRĒJIE",0,28,0,2,30
"SKRUNDAS NOVADS","LATVIJAS PILSONIS",3,4797,0,65,4865
"SKRUNDAS NOVADS","LATVIJAS PAGAIDU AIZSARDZĪBA",0,0,0,0,0
"SKRUNDAS NOVADS","LATVIJAS NEPILSONIS",0,183,0,11,194
"SKRUNDAS NOVADS","LATVIJAS BĒGLIS",0,0,0,0,0
"SKRUNDAS NOVADS","LATVIJAS BEZVALSTNIEKS",0,0,0,0,0
"SKRUNDAS NOVADS","LATVIJAS ALTERNATĪVAIS",0,0,0,0,0
"SKRUNDAS NOVADS","PĀRĒJIE",0,40,0,1,41
"SMILTENES NOVADS","LATVIJAS PILSONIS",1,12492,0,69,12562
"SMILTENES NOVADS","LATVIJAS PAGAIDU AIZSARDZĪBA",0,0,0,0,0
"SMILTENES NOVADS","LATVIJAS NEPILSONIS",0,185,0,2,187
"SMILTENES NOVADS","LATVIJAS BĒGLIS",0,0,0,0,0
"SMILTENES NOVADS","LATVIJAS BEZVALSTNIEKS",0,0,0,0,0
"SMILTENES NOVADS","LATVIJAS ALTERNATĪVAIS",0,0,0,0,0
"SMILTENES NOVADS","PĀRĒJIE",1,34,0,7,42
"STOPIŅU NOVADS","LATVIJAS PILSONIS",0,9157,1,75,9233
"STOPIŅU NOVADS","LATVIJAS PAGAIDU AIZSARDZĪBA",0,0,0,0,0
"STOPIŅU NOVADS","LATVIJAS NEPILSONIS",0,1297,0,33,1330
"STOPIŅU NOVADS","LATVIJAS BĒGLIS",0,1,0,0,1
"STOPIŅU NOVADS","LATVIJAS BEZVALSTNIEKS",0,0,0,0,0
"STOPIŅU NOVADS","LATVIJAS ALTERNATĪVAIS",0,0,0,0,0
"STOPIŅU NOVADS","PĀRĒJIE",0,378,0,1,379
"STRENČU NOVADS","LATVIJAS PILSONIS",1,2717,0,45,2763
"STRENČU NOVADS","LATVIJAS PAGAIDU AIZSARDZĪBA",0,0,0,0,0
"STRENČU NOVADS","LATVIJAS NEPILSONIS",0,496,0,14,510
"STRENČU NOVADS","LATVIJAS BĒGLIS",0,0,0,0,0
"STRENČU NOVADS","LATVIJAS BEZVALSTNIEKS",0,1,0,0,1
"STRENČU NOVADS","LATVIJAS ALTERNATĪVAIS",0,0,0,0,0
"STRENČU NOVADS","PĀRĒJIE",0,68,0,0,68
"TALSU NOVADS","LATVIJAS PILSONIS",0,29485,0,457,29942
"TALSU NOVADS","LATVIJAS PAGAIDU AIZSARDZĪBA",0,0,0,0,0
"TALSU NOVADS","LATVIJAS NEPILSONIS",0,612,0,13,625
"TALSU NOVADS","LATVIJAS BĒGLIS",0,0,0,0,0
"TALSU NOVADS","LATVIJAS BEZVALSTNIEKS",0,7,0,0,7
"TALSU NOVADS","LATVIJAS ALTERNATĪVAIS",0,0,0,0,0
"TALSU NOVADS","PĀRĒJIE",1,141,0,4,146
"TĒRVETES NOVADS","LATVIJAS PILSONIS",0,3160,0,19,3179
"TĒRVETES NOVADS","LATVIJAS PAGAIDU AIZSARDZĪBA",0,0,0,0,0
"TĒRVETES NOVADS","LATVIJAS NEPILSONIS",0,292,0,10,302
"TĒRVETES NOVADS","LATVIJAS BĒGLIS",0,0,0,0,0
"TĒRVETES NOVADS","LATVIJAS BEZVALSTNIEKS",0,0,0,0,0
"TĒRVETES NOVADS","LATVIJAS ALTERNATĪVAIS",0,0,0,0,0
"TĒRVETES NOVADS","PĀRĒJIE",0,23,0,1,24
"TUKUMA NOVADS","LATVIJAS PILSONIS",7,28072,31,441,28551
"TUKUMA NOVADS","LATVIJAS PAGAIDU AIZSARDZĪBA",0,0,0,0,0
"TUKUMA NOVADS","LATVIJAS NEPILSONIS",0,1368,3,83,1454
"TUKUMA NOVADS","LATVIJAS BĒGLIS",0,0,0,0,0
"TUKUMA NOVADS","LATVIJAS BEZVALSTNIEKS",0,5,0,0,5
"TUKUMA NOVADS","LATVIJAS ALTERNATĪVAIS",0,0,0,0,0
"TUKUMA NOVADS","PĀRĒJIE",1,321,0,11,333
"VAIŅODES NOVADS","LATVIJAS PILSONIS",0,2323,0,14,2337
"VAIŅODES NOVADS","LATVIJAS PAGAIDU AIZSARDZĪBA",0,0,0,0,0
"VAIŅODES NOVADS","LATVIJAS NEPILSONIS",0,171,0,1,172
"VAIŅODES NOVADS","LATVIJAS BĒGLIS",0,0,0,0,0
"VAIŅODES NOVADS","LATVIJAS BEZVALSTNIEKS",0,0,0,0,0
"VAIŅODES NOVADS","LATVIJAS ALTERNATĪVAIS",0,0,0,0,0
"VAIŅODES NOVADS","PĀRĒJIE",0,31,0,2,33
"VALKAS NOVADS","LATVIJAS PILSONIS",0,7957,0,100,8057
"VALKAS NOVADS","LATVIJAS PAGAIDU AIZSARDZĪBA",0,0,0,0,0
"VALKAS NOVADS","LATVIJAS NEPILSONIS",0,655,0,50,705
"VALKAS NOVADS","LATVIJAS BĒGLIS",0,0,0,0,0
"VALKAS NOVADS","LATVIJAS BEZVALSTNIEKS",0,0,0,0,0
"VALKAS NOVADS","LATVIJAS ALTERNATĪVAIS",0,0,0,0,0
"VALKAS NOVADS","PĀRĒJIE",3,140,1,7,151
"VARAKĻĀNU NOVADS","LATVIJAS PILSONIS",0,3231,1,15,3247
"VARAKĻĀNU NOVADS","LATVIJAS PAGAIDU AIZSARDZĪBA",0,0,0,0,0
"VARAKĻĀNU NOVADS","LATVIJAS NEPILSONIS",0,67,0,4,71
"VARAKĻĀNU NOVADS","LATVIJAS BĒGLIS",0,0,0,0,0
"VARAKĻĀNU NOVADS","LATVIJAS BEZVALSTNIEKS",0,0,0,0,0
"VARAKĻĀNU NOVADS","LATVIJAS ALTERNATĪVAIS",0,0,0,0,0
"VARAKĻĀNU NOVADS","PĀRĒJIE",0,18,0,1,19
"VĀRKAVAS NOVADS","LATVIJAS PILSONIS",5,1953,0,1,1959
"VĀRKAVAS NOVADS","LATVIJAS PAGAIDU AIZSARDZĪBA",0,0,0,0,0
"VĀRKAVAS NOVADS","LATVIJAS NEPILSONIS",0,28,0,0,28
"VĀRKAVAS NOVADS","LATVIJAS BĒGLIS",0,0,0,0,0
"VĀRKAVAS NOVADS","LATVIJAS BEZVALSTNIEKS",0,0,0,0,0
"VĀRKAVAS NOVADS","LATVIJAS ALTERNATĪVAIS",0,0,0,0,0
"VĀRKAVAS NOVADS","PĀRĒJIE",0,8,0,0,8
"VECPIEBALGAS NOVADS","LATVIJAS PILSONIS",0,3845,1,23,3869
"VECPIEBALGAS NOVADS","LATVIJAS PAGAIDU AIZSARDZĪBA",0,0,0,0,0
"VECPIEBALGAS NOVADS","LATVIJAS NEPILSONIS",0,93,0,6,99
"VECPIEBALGAS NOVADS","LATVIJAS BĒGLIS",0,0,0,0,0
"VECPIEBALGAS NOVADS","LATVIJAS BEZVALSTNIEKS",0,0,0,0,0
"VECPIEBALGAS NOVADS","LATVIJAS ALTERNATĪVAIS",0,0,0,0,0
"VECPIEBALGAS NOVADS","PĀRĒJIE",0,6,0,1,7
"VECUMNIEKU NOVADS","LATVIJAS PILSONIS",0,7891,3,58,7952
"VECUMNIEKU NOVADS","LATVIJAS PAGAIDU AIZSARDZĪBA",0,0,0,0,0
"VECUMNIEKU NOVADS","LATVIJAS NEPILSONIS",0,499,1,26,526
"VECUMNIEKU NOVADS","LATVIJAS BĒGLIS",0,0,0,0,0
"VECUMNIEKU NOVADS","LATVIJAS BEZVALSTNIEKS",0,1,0,0,1
"VECUMNIEKU NOVADS","LATVIJAS ALTERNATĪVAIS",0,1,0,0,1
"VECUMNIEKU NOVADS","PĀRĒJIE",2,85,0,0,87
"VENTSPILS NOVADS","LATVIJAS PILSONIS",0,11144,1,186,11331
"VENTSPILS NOVADS","LATVIJAS PAGAIDU AIZSARDZĪBA",0,0,0,0,0
"VENTSPILS NOVADS","LATVIJAS NEPILSONIS",0,423,0,23,446
"VENTSPILS NOVADS","LATVIJAS BĒGLIS",0,0,0,0,0
"VENTSPILS NOVADS","LATVIJAS BEZVALSTNIEKS",0,0,0,0,0
"VENTSPILS NOVADS","LATVIJAS ALTERNATĪVAIS",0,0,0,0,0
"VENTSPILS NOVADS","PĀRĒJIE",1,117,0,2,120
"VIESĪTES NOVADS","LATVIJAS PILSONIS",0,3617,0,24,3641
"VIESĪTES NOVADS","LATVIJAS PAGAIDU AIZSARDZĪBA",0,0,0,0,0
"VIESĪTES NOVADS","LATVIJAS NEPILSONIS",0,226,0,3,229
"VIESĪTES NOVADS","LATVIJAS BĒGLIS",0,0,0,0,0
"VIESĪTES NOVADS","LATVIJAS BEZVALSTNIEKS",0,0,0,0,0
"VIESĪTES NOVADS","LATVIJAS ALTERNATĪVAIS",0,0,0,0,0
"VIESĪTES NOVADS","PĀRĒJIE",0,14,0,0,14
"VIĻAKAS NOVADS","LATVIJAS PILSONIS",0,4900,3,21,4924
"VIĻAKAS NOVADS","LATVIJAS PAGAIDU AIZSARDZĪBA",0,0,0,0,0
"VIĻAKAS NOVADS","LATVIJAS NEPILSONIS",0,194,0,5,199
"VIĻAKAS NOVADS","LATVIJAS BĒGLIS",0,0,0,0,0
"VIĻAKAS NOVADS","LATVIJAS BEZVALSTNIEKS",0,0,0,0,0
"VIĻAKAS NOVADS","LATVIJAS ALTERNATĪVAIS",0,0,0,0,0
"VIĻAKAS NOVADS","PĀRĒJIE",0,35,0,0,35
"VIĻĀNU NOVADS","LATVIJAS PILSONIS",1,5774,0,31,5806
"VIĻĀNU NOVADS","LATVIJAS PAGAIDU AIZSARDZĪBA",0,0,0,0,0
"VIĻĀNU NOVADS","LATVIJAS NEPILSONIS",0,187,0,7,194
"VIĻĀNU NOVADS","LATVIJAS BĒGLIS",0,0,0,0,0
"VIĻĀNU NOVADS","LATVIJAS BEZVALSTNIEKS",0,0,0,0,0
"VIĻĀNU NOVADS","LATVIJAS ALTERNATĪVAIS",0,0,0,0,0
"VIĻĀNU NOVADS","PĀRĒJIE",0,45,0,0,45
"ZILUPES NOVADS","LATVIJAS PILSONIS",0,2682,0,22,2704
"ZILUPES NOVADS","LATVIJAS PAGAIDU AIZSARDZĪBA",0,0,0,0,0
"ZILUPES NOVADS","LATVIJAS NEPILSONIS",0,262,0,9,271
"ZILUPES NOVADS","LATVIJAS BĒGLIS",0,0,0,0,0
"ZILUPES NOVADS","LATVIJAS BEZVALSTNIEKS",0,0,0,0,0
"ZILUPES NOVADS","LATVIJAS ALTERNATĪVAIS",0,0,0,0,0
"ZILUPES NOVADS","PĀRĒJIE",0,58,0,0,58
