Location,Category,Pointing,Declaring,Registering,RegistrationNotValid,Total
DAUGAVPILS,LATVIJAS PILSONIS,190,74457,1,1724,76372
DAUGAVPILS,LATVIJAS PAGAIDU AIZSARDZIBA,0,0,0,0,0
DAUGAVPILS,LATVIJAS NEPILSONIS,32,16212,1,525,16770
DAUGAVPILS,LATVIJAS BEGLIS,0,0,0,0,0
DAUGAVPILS,LATVIJAS BEZVALSTNIEKS,0,4,0,0,4
DAUGAVPILS,LATVIJAS ALTERNATIVAIS,0,0,0,0,0
DAUGAVPILS,PAREJIE,51,5692,2,31,5776
JELGAVA,LATVIJAS PILSONIS,131,49321,0,1640,51092
JELGAVA,LATVIJAS PAGAIDU AIZSARDZIBA,0,0,0,0,0
JELGAVA,LATVIJAS NEPILSONIS,102,8827,0,948,9877
JELGAVA,LATVIJAS BEGLIS,0,0,0,0,0
JELGAVA,LATVIJAS BEZVALSTNIEKS,0,1,0,0,1
JELGAVA,LATVIJAS ALTERNATIVAIS,0,0,0,0,0
JELGAVA,PAREJIE,39,1747,0,44,1830
JEKABPILS,LATVIJAS PILSONIS,91,20768,225,860,21944
JEKABPILS,LATVIJAS PAGAIDU AIZSARDZIBA,0,0,0,0,0
JEKABPILS,LATVIJAS NEPILSONIS,16,2636,2,196,2850
JEKABPILS,LATVIJAS BEGLIS,0,0,0,0,0
JEKABPILS,LATVIJAS BEZVALSTNIEKS,0,6,0,0,6
JEKABPILS,LATVIJAS ALTERNATIVAIS,0,0,0,0,0
JEKABPILS,PAREJIE,7,401,1,12,421
JURMALA,LATVIJAS PILSONIS,171,42426,11,1197,43805
JURMALA,LATVIJAS PAGAIDU AIZSARDZIBA,0,0,0,0,0
JURMALA,LATVIJAS NEPILSONIS,132,8616,4,974,9726
JURMALA,LATVIJAS BEGLIS,0,1,0,0,1
JURMALA,LATVIJAS BEZVALSTNIEKS,0,4,0,0,4
JURMALA,LATVIJAS ALTERNATIVAIS,0,1,0,0,1
JURMALA,PAREJIE,96,3774,2,54,3926
LIEPAJA,LATVIJAS PILSONIS,132,58717,13,1612,60474
LIEPAJA,LATVIJAS PAGAIDU AIZSARDZIBA,0,0,0,0,0
LIEPAJA,LATVIJAS NEPILSONIS,40,13507,0,1298,14845
LIEPAJA,LATVIJAS BEGLIS,0,0,0,0,0
LIEPAJA,LATVIJAS BEZVALSTNIEKS,1,10,0,0,11
LIEPAJA,LATVIJAS ALTERNATIVAIS,0,0,0,0,0
LIEPAJA,PAREJIE,73,5313,1,46,5433
REZEKNE,LATVIJAS PILSONIS,81,29450,0,758,30289
REZEKNE,LATVIJAS PAGAIDU AIZSARDZIBA,0,0,0,0,0
REZEKNE,LATVIJAS NEPILSONIS,9,1968,0,207,2184
REZEKNE,LATVIJAS BEGLIS,0,0,0,0,0
REZEKNE,LATVIJAS BEZVALSTNIEKS,0,0,0,0,0
REZEKNE,LATVIJAS ALTERNATIVAIS,0,0,0,0,0
REZEKNE,PAREJIE,7,551,0,11,569
RIGA,LATVIJAS PILSONIS,3935,492887,424,12512,509758
RIGA,LATVIJAS PAGAIDU AIZSARDZIBA,0,0,0,0,0
RIGA,LATVIJAS NEPILSONIS,1193,136631,256,11199,149279
RIGA,LATVIJAS BEGLIS,0,32,0,1,33
RIGA,LATVIJAS BEZVALSTNIEKS,1,95,0,2,98
RIGA,LATVIJAS ALTERNATIVAIS,0,63,0,0,63
RIGA,PAREJIE,1250,34238,9,811,36308
VALMIERA,LATVIJAS PILSONIS,35,23604,39,737,24415
VALMIERA,LATVIJAS PAGAIDU AIZSARDZIBA,0,0,0,0,0
VALMIERA,LATVIJAS NEPILSONIS,0,1399,9,76,1484
VALMIERA,LATVIJAS BEGLIS,0,0,0,0,0
VALMIERA,LATVIJAS BEZVALSTNIEKS,0,0,0,0,0
VALMIERA,LATVIJAS ALTERNATIVAIS,0,0,0,0,0
VALMIERA,PAREJIE,2,160,0,1,163
VENTSPILS,LATVIJAS PILSONIS,165,30565,1,730,31461
VENTSPILS,LATVIJAS PAGAIDU AIZSARDZIBA,0,0,0,0,0
VENTSPILS,LATVIJAS NEPILSONIS,20,6821,0,329,7170
VENTSPILS,LATVIJAS BEGLIS,0,0,0,0,0
VENTSPILS,LATVIJAS BEZVALSTNIEKS,0,4,0,0,4
VENTSPILS,LATVIJAS ALTERNATIVAIS,0,0,0,0,0
VENTSPILS,PAREJIE,32,2298,0,26,2356
AGLONAS NOVADS,LATVIJAS PILSONIS,15,3826,0,23,3864
AGLONAS NOVADS,LATVIJAS PAGAIDU AIZSARDZIBA,0,0,0,0,0
AGLONAS NOVADS,LATVIJAS NEPILSONIS,4,236,0,4,244
AGLONAS NOVADS,LATVIJAS BEGLIS,0,0,0,0,0
AGLONAS NOVADS,LATVIJAS BEZVALSTNIEKS,0,0,0,0,0
AGLONAS NOVADS,LATVIJAS ALTERNATIVAIS,0,0,0,0,0
AGLONAS NOVADS,PAREJIE,0,45,0,1,46
AIZKRAUKLES NOVADS,LATVIJAS PILSONIS,59,8083,1,150,8293
AIZKRAUKLES NOVADS,LATVIJAS PAGAIDU AIZSARDZIBA,0,0,0,0,0
AIZKRAUKLES NOVADS,LATVIJAS NEPILSONIS,17,923,0,62,1002
AIZKRAUKLES NOVADS,LATVIJAS BEGLIS,0,0,0,0,0
AIZKRAUKLES NOVADS,LATVIJAS BEZVALSTNIEKS,0,1,0,0,1
AIZKRAUKLES NOVADS,LATVIJAS ALTERNATIVAIS,0,0,0,0,0
AIZKRAUKLES NOVADS,PAREJIE,4,80,0,4,88
AIZPUTES NOVADS,LATVIJAS PILSONIS,29,9555,1,71,9656
AIZPUTES NOVADS,LATVIJAS PAGAIDU AIZSARDZIBA,0,0,0,0,0
AIZPUTES NOVADS,LATVIJAS NEPILSONIS,2,247,0,7,256
AIZPUTES NOVADS,LATVIJAS BEGLIS,0,0,0,0,0
AIZPUTES NOVADS,LATVIJAS BEZVALSTNIEKS,0,0,0,0,0
AIZPUTES NOVADS,LATVIJAS ALTERNATIVAIS,0,0,0,0,0
AIZPUTES NOVADS,PAREJIE,3,25,0,0,28
AKNISTES NOVADS,LATVIJAS PILSONIS,2,2796,1,7,2806
AKNISTES NOVADS,LATVIJAS PAGAIDU AIZSARDZIBA,0,0,0,0,0
AKNISTES NOVADS,LATVIJAS NEPILSONIS,1,241,0,1,243
AKNISTES NOVADS,LATVIJAS BEGLIS,0,0,0,0,0
AKNISTES NOVADS,LATVIJAS BEZVALSTNIEKS,0,0,0,0,0
AKNISTES NOVADS,LATVIJAS ALTERNATIVAIS,0,0,0,0,0
AKNISTES NOVADS,PAREJIE,0,13,0,0,13
ALOJAS NOVADS,LATVIJAS PILSONIS,60,5430,0,21,5511
ALOJAS NOVADS,LATVIJAS PAGAIDU AIZSARDZIBA,0,0,0,0,0
ALOJAS NOVADS,LATVIJAS NEPILSONIS,0,227,0,3,230
ALOJAS NOVADS,LATVIJAS BEGLIS,0,0,0,0,0
ALOJAS NOVADS,LATVIJAS BEZVALSTNIEKS,0,0,0,0,0
ALOJAS NOVADS,LATVIJAS ALTERNATIVAIS,0,0,0,0,0
ALOJAS NOVADS,PAREJIE,0,9,0,0,9
ALSUNGAS NOVADS,LATVIJAS PILSONIS,2,1551,5,12,1570
ALSUNGAS NOVADS,LATVIJAS PAGAIDU AIZSARDZIBA,0,0,0,0,0
ALSUNGAS NOVADS,LATVIJAS NEPILSONIS,0,24,1,1,26
ALSUNGAS NOVADS,LATVIJAS BEGLIS,0,0,0,0,0
ALSUNGAS NOVADS,LATVIJAS BEZVALSTNIEKS,0,0,0,0,0
ALSUNGAS NOVADS,LATVIJAS ALTERNATIVAIS,0,0,0,0,0
ALSUNGAS NOVADS,PAREJIE,0,2,0,0,2
ALUKSNES NOVADS,LATVIJAS PILSONIS,47,17222,6,149,17424
ALUKSNES NOVADS,LATVIJAS PAGAIDU AIZSARDZIBA,0,0,0,0,0
ALUKSNES NOVADS,LATVIJAS NEPILSONIS,0,690,0,26,716
ALUKSNES NOVADS,LATVIJAS BEGLIS,0,0,0,0,0
ALUKSNES NOVADS,LATVIJAS BEZVALSTNIEKS,0,1,0,0,1
ALUKSNES NOVADS,LATVIJAS ALTERNATIVAIS,0,0,0,0,0
ALUKSNES NOVADS,PAREJIE,8,148,0,4,160
AMATAS NOVADS,LATVIJAS PILSONIS,32,5746,0,45,5823
AMATAS NOVADS,LATVIJAS PAGAIDU AIZSARDZIBA,0,0,0,0,0
AMATAS NOVADS,LATVIJAS NEPILSONIS,0,253,0,3,256
AMATAS NOVADS,LATVIJAS BEGLIS,0,0,0,0,0
AMATAS NOVADS,LATVIJAS BEZVALSTNIEKS,0,0,0,0,0
AMATAS NOVADS,LATVIJAS ALTERNATIVAIS,0,0,0,0,0
AMATAS NOVADS,PAREJIE,3,87,0,0,90
APES NOVADS,LATVIJAS PILSONIS,4,3864,1,16,3885
APES NOVADS,LATVIJAS PAGAIDU AIZSARDZIBA,0,0,0,0,0
APES NOVADS,LATVIJAS NEPILSONIS,0,128,0,0,128
APES NOVADS,LATVIJAS BEGLIS,0,0,0,0,0
APES NOVADS,LATVIJAS BEZVALSTNIEKS,0,0,0,0,0
APES NOVADS,LATVIJAS ALTERNATIVAIS,0,0,0,0,0
APES NOVADS,PAREJIE,0,20,0,0,20
AUCES NOVADS,LATVIJAS PILSONIS,21,7169,0,69,7259
AUCES NOVADS,LATVIJAS PAGAIDU AIZSARDZIBA,0,0,0,0,0
AUCES NOVADS,LATVIJAS NEPILSONIS,4,752,0,27,783
AUCES NOVADS,LATVIJAS BEGLIS,0,0,0,0,0
AUCES NOVADS,LATVIJAS BEZVALSTNIEKS,0,0,0,0,0
AUCES NOVADS,LATVIJAS ALTERNATIVAIS,0,0,0,0,0
AUCES NOVADS,PAREJIE,12,36,0,2,50
ADAZU NOVADS,LATVIJAS PILSONIS,22,8900,0,149,9071
ADAZU NOVADS,LATVIJAS PAGAIDU AIZSARDZIBA,0,0,0,0,0
ADAZU NOVADS,LATVIJAS NEPILSONIS,14,908,0,54,976
ADAZU NOVADS,LATVIJAS BEGLIS,0,0,0,0,0
ADAZU NOVADS,LATVIJAS BEZVALSTNIEKS,0,1,0,0,1
ADAZU NOVADS,LATVIJAS ALTERNATIVAIS,0,0,0,0,0
ADAZU NOVADS,PAREJIE,4,227,0,1,232
BABITES NOVADS,LATVIJAS PILSONIS,15,8493,1,104,8613
BABITES NOVADS,LATVIJAS PAGAIDU AIZSARDZIBA,0,0,0,0,0
BABITES NOVADS,LATVIJAS NEPILSONIS,2,806,0,24,832
BABITES NOVADS,LATVIJAS BEGLIS,0,0,0,0,0
BABITES NOVADS,LATVIJAS BEZVALSTNIEKS,0,0,0,0,0
BABITES NOVADS,LATVIJAS ALTERNATIVAIS,0,0,0,0,0
BABITES NOVADS,PAREJIE,10,422,0,0,432
BALDONES NOVADS,LATVIJAS PILSONIS,17,5230,0,63,5310
BALDONES NOVADS,LATVIJAS PAGAIDU AIZSARDZIBA,0,0,0,0,0
BALDONES NOVADS,LATVIJAS NEPILSONIS,0,303,0,13,316
BALDONES NOVADS,LATVIJAS BEGLIS,0,0,0,0,0
BALDONES NOVADS,LATVIJAS BEZVALSTNIEKS,0,0,0,0,0
BALDONES NOVADS,LATVIJAS ALTERNATIVAIS,0,0,0,0,0
BALDONES NOVADS,PAREJIE,0,30,0,2,32
BALTINAVAS NOVADS,LATVIJAS PILSONIS,4,1226,0,3,1233
BALTINAVAS NOVADS,LATVIJAS PAGAIDU AIZSARDZIBA,0,0,0,0,0
BALTINAVAS NOVADS,LATVIJAS NEPILSONIS,0,25,0,1,26
BALTINAVAS NOVADS,LATVIJAS BEGLIS,0,0,0,0,0
BALTINAVAS NOVADS,LATVIJAS BEZVALSTNIEKS,0,0,0,0,0
BALTINAVAS NOVADS,LATVIJAS ALTERNATIVAIS,0,0,0,0,0
BALTINAVAS NOVADS,PAREJIE,0,7,0,2,9
BALVU NOVADS,LATVIJAS PILSONIS,34,14088,5,140,14267
BALVU NOVADS,LATVIJAS PAGAIDU AIZSARDZIBA,0,0,0,0,0
BALVU NOVADS,LATVIJAS NEPILSONIS,2,446,1,39,488
BALVU NOVADS,LATVIJAS BEGLIS,0,0,0,0,0
BALVU NOVADS,LATVIJAS BEZVALSTNIEKS,0,0,0,0,0
BALVU NOVADS,LATVIJAS ALTERNATIVAIS,0,0,0,0,0
BALVU NOVADS,PAREJIE,2,60,0,4,66
BAUSKAS NOVADS,LATVIJAS PILSONIS,102,23736,1,261,24100
BAUSKAS NOVADS,LATVIJAS PAGAIDU AIZSARDZIBA,0,0,0,0,0
BAUSKAS NOVADS,LATVIJAS NEPILSONIS,8,2241,0,103,2352
BAUSKAS NOVADS,LATVIJAS BEGLIS,0,0,0,0,0
BAUSKAS NOVADS,LATVIJAS BEZVALSTNIEKS,0,1,0,0,1
BAUSKAS NOVADS,LATVIJAS ALTERNATIVAIS,0,0,0,0,0
BAUSKAS NOVADS,PAREJIE,7,171,0,3,181
BEVERINAS NOVADS,LATVIJAS PILSONIS,14,3244,0,28,3286
BEVERINAS NOVADS,LATVIJAS PAGAIDU AIZSARDZIBA,0,0,0,0,0
BEVERINAS NOVADS,LATVIJAS NEPILSONIS,2,170,0,1,173
BEVERINAS NOVADS,LATVIJAS BEGLIS,0,0,0,0,0
BEVERINAS NOVADS,LATVIJAS BEZVALSTNIEKS,0,0,0,0,0
BEVERINAS NOVADS,LATVIJAS ALTERNATIVAIS,0,0,0,0,0
BEVERINAS NOVADS,PAREJIE,1,14,0,0,15
BROCENU NOVADS,LATVIJAS PILSONIS,17,5968,0,78,6063
BROCENU NOVADS,LATVIJAS PAGAIDU AIZSARDZIBA,0,0,0,0,0
BROCENU NOVADS,LATVIJAS NEPILSONIS,4,454,0,43,501
BROCENU NOVADS,LATVIJAS BEGLIS,0,0,0,0,0
BROCENU NOVADS,LATVIJAS BEZVALSTNIEKS,0,0,0,0,0
BROCENU NOVADS,LATVIJAS ALTERNATIVAIS,0,0,0,0,0
BROCENU NOVADS,PAREJIE,1,53,0,1,55
BURTNIEKU NOVADS,LATVIJAS PILSONIS,31,7481,0,78,7590
BURTNIEKU NOVADS,LATVIJAS PAGAIDU AIZSARDZIBA,0,0,0,0,0
BURTNIEKU NOVADS,LATVIJAS NEPILSONIS,21,492,0,25,538
BURTNIEKU NOVADS,LATVIJAS BEGLIS,0,0,0,0,0
BURTNIEKU NOVADS,LATVIJAS BEZVALSTNIEKS,0,0,0,0,0
BURTNIEKU NOVADS,LATVIJAS ALTERNATIVAIS,0,0,0,1,1
BURTNIEKU NOVADS,PAREJIE,0,40,0,0,40
CARNIKAVAS NOVADS,LATVIJAS PILSONIS,19,5753,1,91,5864
CARNIKAVAS NOVADS,LATVIJAS PAGAIDU AIZSARDZIBA,0,0,0,0,0
CARNIKAVAS NOVADS,LATVIJAS NEPILSONIS,4,809,0,29,842
CARNIKAVAS NOVADS,LATVIJAS BEGLIS,0,0,0,0,0
CARNIKAVAS NOVADS,LATVIJAS BEZVALSTNIEKS,0,2,0,0,2
CARNIKAVAS NOVADS,LATVIJAS ALTERNATIVAIS,0,0,0,0,0
CARNIKAVAS NOVADS,PAREJIE,9,175,0,2,186
CESVAINES NOVADS,LATVIJAS PILSONIS,2,2914,3,5,2924
CESVAINES NOVADS,LATVIJAS PAGAIDU AIZSARDZIBA,0,0,0,0,0
CESVAINES NOVADS,LATVIJAS NEPILSONIS,0,64,0,1,65
CESVAINES NOVADS,LATVIJAS BEGLIS,0,0,0,0,0
CESVAINES NOVADS,LATVIJAS BEZVALSTNIEKS,0,0,0,0,0
CESVAINES NOVADS,LATVIJAS ALTERNATIVAIS,0,0,0,0,0
CESVAINES NOVADS,PAREJIE,1,7,0,0,8
CESU NOVADS,LATVIJAS PILSONIS,34,17496,0,378,17908
CESU NOVADS,LATVIJAS PAGAIDU AIZSARDZIBA,0,0,0,0,0
CESU NOVADS,LATVIJAS NEPILSONIS,3,865,0,72,940
CESU NOVADS,LATVIJAS BEGLIS,0,0,0,0,0
CESU NOVADS,LATVIJAS BEZVALSTNIEKS,0,1,0,0,1
CESU NOVADS,LATVIJAS ALTERNATIVAIS,0,0,0,0,0
CESU NOVADS,PAREJIE,5,192,0,2,199
CIBLAS NOVADS,LATVIJAS PILSONIS,23,2889,0,13,2925
CIBLAS NOVADS,LATVIJAS PAGAIDU AIZSARDZIBA,0,0,0,0,0
CIBLAS NOVADS,LATVIJAS NEPILSONIS,2,167,0,11,180
CIBLAS NOVADS,LATVIJAS BEGLIS,0,0,0,0,0
CIBLAS NOVADS,LATVIJAS BEZVALSTNIEKS,0,0,0,0,0
CIBLAS NOVADS,LATVIJAS ALTERNATIVAIS,0,0,0,0,0
CIBLAS NOVADS,PAREJIE,0,27,0,0,27
DAGDAS NOVADS,LATVIJAS PILSONIS,36,7912,1,51,8000
DAGDAS NOVADS,LATVIJAS PAGAIDU AIZSARDZIBA,0,0,0,0,0
DAGDAS NOVADS,LATVIJAS NEPILSONIS,1,659,1,13,674
DAGDAS NOVADS,LATVIJAS BEGLIS,0,0,0,0,0
DAGDAS NOVADS,LATVIJAS BEZVALSTNIEKS,0,0,0,0,0
DAGDAS NOVADS,LATVIJAS ALTERNATIVAIS,0,0,0,0,0
DAGDAS NOVADS,PAREJIE,0,106,0,0,106
DAUGAVPILS NOVADS,LATVIJAS PILSONIS,71,22123,3,201,22398
DAUGAVPILS NOVADS,LATVIJAS PAGAIDU AIZSARDZIBA,0,0,0,0,0
DAUGAVPILS NOVADS,LATVIJAS NEPILSONIS,7,3356,0,60,3423
DAUGAVPILS NOVADS,LATVIJAS BEGLIS,0,0,0,0,0
DAUGAVPILS NOVADS,LATVIJAS BEZVALSTNIEKS,0,2,0,0,2
DAUGAVPILS NOVADS,LATVIJAS ALTERNATIVAIS,0,0,0,0,0
DAUGAVPILS NOVADS,PAREJIE,2,719,0,4,725
DOBELES NOVADS,LATVIJAS PILSONIS,26,20137,2,310,20475
DOBELES NOVADS,LATVIJAS PAGAIDU AIZSARDZIBA,0,0,0,0,0
DOBELES NOVADS,LATVIJAS NEPILSONIS,4,2414,0,103,2521
DOBELES NOVADS,LATVIJAS BEGLIS,0,0,0,0,0
DOBELES NOVADS,LATVIJAS BEZVALSTNIEKS,0,1,0,0,1
DOBELES NOVADS,LATVIJAS ALTERNATIVAIS,0,0,0,0,0
DOBELES NOVADS,PAREJIE,12,256,0,10,278
DUNDAGAS NOVADS,LATVIJAS PILSONIS,44,4428,1,26,4499
DUNDAGAS NOVADS,LATVIJAS PAGAIDU AIZSARDZIBA,0,0,0,0,0
DUNDAGAS NOVADS,LATVIJAS NEPILSONIS,0,79,0,1,80
DUNDAGAS NOVADS,LATVIJAS BEGLIS,0,0,0,0,0
DUNDAGAS NOVADS,LATVIJAS BEZVALSTNIEKS,0,0,0,0,0
DUNDAGAS NOVADS,LATVIJAS ALTERNATIVAIS,0,0,0,0,0
DUNDAGAS NOVADS,PAREJIE,1,15,0,1,17
DURBES NOVADS,LATVIJAS PILSONIS,5,3095,0,18,3118
DURBES NOVADS,LATVIJAS PAGAIDU AIZSARDZIBA,0,0,0,0,0
DURBES NOVADS,LATVIJAS NEPILSONIS,0,94,0,1,95
DURBES NOVADS,LATVIJAS BEGLIS,0,0,0,0,0
DURBES NOVADS,LATVIJAS BEZVALSTNIEKS,0,0,0,0,0
DURBES NOVADS,LATVIJAS ALTERNATIVAIS,0,0,0,0,0
DURBES NOVADS,PAREJIE,0,13,0,0,13
ENGURES NOVADS,LATVIJAS PILSONIS,37,7328,0,52,7417
ENGURES NOVADS,LATVIJAS PAGAIDU AIZSARDZIBA,0,0,0,0,0
ENGURES NOVADS,LATVIJAS NEPILSONIS,1,317,0,18,336
ENGURES NOVADS,LATVIJAS BEGLIS,0,1,0,0,1
ENGURES NOVADS,LATVIJAS BEZVALSTNIEKS,0,0,0,0,0
ENGURES NOVADS,LATVIJAS ALTERNATIVAIS,0,0,0,0,0
ENGURES NOVADS,PAREJIE,3,95,0,3,101
ERGLU NOVADS,LATVIJAS PILSONIS,13,3228,0,11,3252
ERGLU NOVADS,LATVIJAS PAGAIDU AIZSARDZIBA,0,0,0,0,0
ERGLU NOVADS,LATVIJAS NEPILSONIS,1,80,0,6,87
ERGLU NOVADS,LATVIJAS BEGLIS,0,0,0,0,0
ERGLU NOVADS,LATVIJAS BEZVALSTNIEKS,0,1,0,0,1
ERGLU NOVADS,LATVIJAS ALTERNATIVAIS,0,0,0,0,0
ERGLU NOVADS,PAREJIE,0,31,0,0,31
GARKALNES NOVADS,LATVIJAS PILSONIS,40,6647,0,59,6746
GARKALNES NOVADS,LATVIJAS PAGAIDU AIZSARDZIBA,0,0,0,0,0
GARKALNES NOVADS,LATVIJAS NEPILSONIS,4,784,0,25,813
GARKALNES NOVADS,LATVIJAS BEGLIS,0,0,0,0,0
GARKALNES NOVADS,LATVIJAS BEZVALSTNIEKS,0,0,0,0,0
GARKALNES NOVADS,LATVIJAS ALTERNATIVAIS,0,0,0,0,0
GARKALNES NOVADS,PAREJIE,15,362,0,6,383
GROBINAS NOVADS,LATVIJAS PILSONIS,20,9242,2,96,9360
GROBINAS NOVADS,LATVIJAS PAGAIDU AIZSARDZIBA,0,0,0,0,0
GROBINAS NOVADS,LATVIJAS NEPILSONIS,5,484,0,18,507
GROBINAS NOVADS,LATVIJAS BEGLIS,0,0,0,0,0
GROBINAS NOVADS,LATVIJAS BEZVALSTNIEKS,0,0,0,0,0
GROBINAS NOVADS,LATVIJAS ALTERNATIVAIS,0,0,0,0,0
GROBINAS NOVADS,PAREJIE,7,93,0,0,100
GULBENES NOVADS,LATVIJAS PILSONIS,51,22771,12,186,23020
GULBENES NOVADS,LATVIJAS PAGAIDU AIZSARDZIBA,0,0,0,0,0
GULBENES NOVADS,LATVIJAS NEPILSONIS,2,876,0,30,908
GULBENES NOVADS,LATVIJAS BEGLIS,0,0,0,0,0
GULBENES NOVADS,LATVIJAS BEZVALSTNIEKS,0,1,0,0,1
GULBENES NOVADS,LATVIJAS ALTERNATIVAIS,0,0,0,0,0
GULBENES NOVADS,PAREJIE,5,98,0,2,105
IECAVAS NOVADS,LATVIJAS PILSONIS,24,8145,1,146,8316
IECAVAS NOVADS,LATVIJAS PAGAIDU AIZSARDZIBA,0,0,0,0,0
IECAVAS NOVADS,LATVIJAS NEPILSONIS,1,1051,0,53,1105
IECAVAS NOVADS,LATVIJAS BEGLIS,0,0,0,0,0
IECAVAS NOVADS,LATVIJAS BEZVALSTNIEKS,0,0,0,0,0
IECAVAS NOVADS,LATVIJAS ALTERNATIVAIS,0,0,0,0,0
IECAVAS NOVADS,PAREJIE,11,104,0,0,115
IKSKILES NOVADS,LATVIJAS PILSONIS,10,8676,1,79,8766
IKSKILES NOVADS,LATVIJAS PAGAIDU AIZSARDZIBA,0,0,0,0,0
IKSKILES NOVADS,LATVIJAS NEPILSONIS,1,317,0,21,339
IKSKILES NOVADS,LATVIJAS BEGLIS,0,0,0,0,0
IKSKILES NOVADS,LATVIJAS BEZVALSTNIEKS,0,0,0,0,0
IKSKILES NOVADS,LATVIJAS ALTERNATIVAIS,0,0,0,0,0
IKSKILES NOVADS,PAREJIE,3,100,0,3,106
ILUKSTES NOVADS,LATVIJAS PILSONIS,7,7677,0,44,7728
ILUKSTES NOVADS,LATVIJAS PAGAIDU AIZSARDZIBA,0,0,0,0,0
ILUKSTES NOVADS,LATVIJAS NEPILSONIS,1,706,0,7,714
ILUKSTES NOVADS,LATVIJAS BEGLIS,0,0,0,0,0
ILUKSTES NOVADS,LATVIJAS BEZVALSTNIEKS,0,1,0,0,1
ILUKSTES NOVADS,LATVIJAS ALTERNATIVAIS,0,0,0,0,0
ILUKSTES NOVADS,PAREJIE,0,113,0,0,113
INCUKALNA NOVADS,LATVIJAS PILSONIS,22,6525,5,178,6730
INCUKALNA NOVADS,LATVIJAS PAGAIDU AIZSARDZIBA,0,0,0,0,0
INCUKALNA NOVADS,LATVIJAS NEPILSONIS,2,1348,1,90,1441
INCUKALNA NOVADS,LATVIJAS BEGLIS,0,0,0,0,0
INCUKALNA NOVADS,LATVIJAS BEZVALSTNIEKS,0,0,0,0,0
INCUKALNA NOVADS,LATVIJAS ALTERNATIVAIS,0,0,0,0,0
INCUKALNA NOVADS,PAREJIE,9,204,0,4,217
JAUNJELGAVAS NOVADS,LATVIJAS PILSONIS,47,5745,2,24,5818
JAUNJELGAVAS NOVADS,LATVIJAS PAGAIDU AIZSARDZIBA,0,0,0,0,0
JAUNJELGAVAS NOVADS,LATVIJAS NEPILSONIS,1,407,1,50,459
JAUNJELGAVAS NOVADS,LATVIJAS BEGLIS,0,0,0,0,0
JAUNJELGAVAS NOVADS,LATVIJAS BEZVALSTNIEKS,0,0,0,0,0
JAUNJELGAVAS NOVADS,LATVIJAS ALTERNATIVAIS,0,0,0,0,0
JAUNJELGAVAS NOVADS,PAREJIE,0,29,0,0,29
JAUNPIEBALGAS NOVADS,LATVIJAS PILSONIS,23,2452,3,14,2492
JAUNPIEBALGAS NOVADS,LATVIJAS PAGAIDU AIZSARDZIBA,0,0,0,0,0
JAUNPIEBALGAS NOVADS,LATVIJAS NEPILSONIS,0,50,0,0,50
JAUNPIEBALGAS NOVADS,LATVIJAS BEGLIS,0,0,0,0,0
JAUNPIEBALGAS NOVADS,LATVIJAS BEZVALSTNIEKS,0,0,0,0,0
JAUNPIEBALGAS NOVADS,LATVIJAS ALTERNATIVAIS,0,0,0,0,0
JAUNPIEBALGAS NOVADS,PAREJIE,1,3,0,0,4
JAUNPILS NOVADS,LATVIJAS PILSONIS,4,2592,0,10,2606
JAUNPILS NOVADS,LATVIJAS PAGAIDU AIZSARDZIBA,0,0,0,0,0
JAUNPILS NOVADS,LATVIJAS NEPILSONIS,0,81,0,4,85
JAUNPILS NOVADS,LATVIJAS BEGLIS,0,0,0,0,0
JAUNPILS NOVADS,LATVIJAS BEZVALSTNIEKS,0,0,0,0,0
JAUNPILS NOVADS,LATVIJAS ALTERNATIVAIS,0,0,0,0,0
JAUNPILS NOVADS,PAREJIE,0,4,0,0,4
JELGAVAS NOVADS,LATVIJAS PILSONIS,87,21988,1,206,22282
JELGAVAS NOVADS,LATVIJAS PAGAIDU AIZSARDZIBA,0,0,0,0,0
JELGAVAS NOVADS,LATVIJAS NEPILSONIS,14,3437,3,141,3595
JELGAVAS NOVADS,LATVIJAS BEGLIS,0,0,0,0,0
JELGAVAS NOVADS,LATVIJAS BEZVALSTNIEKS,0,0,0,0,0
JELGAVAS NOVADS,LATVIJAS ALTERNATIVAIS,0,0,0,0,0
JELGAVAS NOVADS,PAREJIE,12,255,0,6,273
JEKABPILS NOVADS,LATVIJAS PILSONIS,10,5150,3,44,5207
JEKABPILS NOVADS,LATVIJAS PAGAIDU AIZSARDZIBA,0,0,0,0,0
JEKABPILS NOVADS,LATVIJAS NEPILSONIS,0,162,0,4,166
JEKABPILS NOVADS,LATVIJAS BEGLIS,0,0,0,0,0
JEKABPILS NOVADS,LATVIJAS BEZVALSTNIEKS,0,0,0,0,0
JEKABPILS NOVADS,LATVIJAS ALTERNATIVAIS,0,0,0,0,0
JEKABPILS NOVADS,PAREJIE,3,14,1,0,18
KANDAVAS NOVADS,LATVIJAS PILSONIS,28,9122,3,85,9238
KANDAVAS NOVADS,LATVIJAS PAGAIDU AIZSARDZIBA,0,0,0,0,0
KANDAVAS NOVADS,LATVIJAS NEPILSONIS,2,268,0,4,274
KANDAVAS NOVADS,LATVIJAS BEGLIS,0,0,0,0,0
KANDAVAS NOVADS,LATVIJAS BEZVALSTNIEKS,0,0,0,0,0
KANDAVAS NOVADS,LATVIJAS ALTERNATIVAIS,0,0,0,0,0
KANDAVAS NOVADS,PAREJIE,16,27,0,1,44
KARSAVAS NOVADS,LATVIJAS PILSONIS,18,6142,1,34,6195
KARSAVAS NOVADS,LATVIJAS PAGAIDU AIZSARDZIBA,0,0,0,0,0
KARSAVAS NOVADS,LATVIJAS NEPILSONIS,0,281,0,9,290
KARSAVAS NOVADS,LATVIJAS BEGLIS,0,0,0,0,0
KARSAVAS NOVADS,LATVIJAS BEZVALSTNIEKS,0,0,0,0,0
KARSAVAS NOVADS,LATVIJAS ALTERNATIVAIS,0,0,0,0,0
KARSAVAS NOVADS,PAREJIE,1,43,0,0,44
KOCENU NOVADS,LATVIJAS PILSONIS,47,6214,5,78,6344
KOCENU NOVADS,LATVIJAS PAGAIDU AIZSARDZIBA,0,0,0,0,0
KOCENU NOVADS,LATVIJAS NEPILSONIS,1,398,0,11,410
KOCENU NOVADS,LATVIJAS BEGLIS,0,0,0,0,0
KOCENU NOVADS,LATVIJAS BEZVALSTNIEKS,0,0,0,0,0
KOCENU NOVADS,LATVIJAS ALTERNATIVAIS,0,0,0,0,0
KOCENU NOVADS,PAREJIE,0,20,0,0,20
KOKNESES NOVADS,LATVIJAS PILSONIS,8,5556,0,47,5611
KOKNESES NOVADS,LATVIJAS PAGAIDU AIZSARDZIBA,0,0,0,0,0
KOKNESES NOVADS,LATVIJAS NEPILSONIS,2,179,0,42,223
KOKNESES NOVADS,LATVIJAS BEGLIS,0,0,0,0,0
KOKNESES NOVADS,LATVIJAS BEZVALSTNIEKS,0,1,0,0,1
KOKNESES NOVADS,LATVIJAS ALTERNATIVAIS,0,0,0,0,0
KOKNESES NOVADS,PAREJIE,0,13,0,0,13
KRASLAVAS NOVADS,LATVIJAS PILSONIS,110,15355,11,241,15717
KRASLAVAS NOVADS,LATVIJAS PAGAIDU AIZSARDZIBA,0,0,0,0,0
KRASLAVAS NOVADS,LATVIJAS NEPILSONIS,2,2411,1,89,2503
KRASLAVAS NOVADS,LATVIJAS BEGLIS,0,0,0,0,0
KRASLAVAS NOVADS,LATVIJAS BEZVALSTNIEKS,0,1,0,0,1
KRASLAVAS NOVADS,LATVIJAS ALTERNATIVAIS,0,0,0,0,0
KRASLAVAS NOVADS,PAREJIE,1,476,0,3,480
KRIMULDAS NOVADS,LATVIJAS PILSONIS,9,5407,1,20,5437
KRIMULDAS NOVADS,LATVIJAS PAGAIDU AIZSARDZIBA,0,0,0,0,0
KRIMULDAS NOVADS,LATVIJAS NEPILSONIS,1,138,0,4,143
KRIMULDAS NOVADS,LATVIJAS BEGLIS,0,0,0,0,0
KRIMULDAS NOVADS,LATVIJAS BEZVALSTNIEKS,0,1,0,0,1
KRIMULDAS NOVADS,LATVIJAS ALTERNATIVAIS,0,0,0,0,0
KRIMULDAS NOVADS,PAREJIE,3,15,0,0,18
KRUSTPILS NOVADS,LATVIJAS PILSONIS,22,6028,0,46,6096
KRUSTPILS NOVADS,LATVIJAS PAGAIDU AIZSARDZIBA,0,0,0,0,0
KRUSTPILS NOVADS,LATVIJAS NEPILSONIS,3,449,0,11,463
KRUSTPILS NOVADS,LATVIJAS BEGLIS,0,0,0,0,0
KRUSTPILS NOVADS,LATVIJAS BEZVALSTNIEKS,0,2,0,0,2
KRUSTPILS NOVADS,LATVIJAS ALTERNATIVAIS,0,0,0,0,0
KRUSTPILS NOVADS,PAREJIE,0,26,0,0,26
KULDIGAS NOVADS,LATVIJAS PILSONIS,73,25134,1,419,25627
KULDIGAS NOVADS,LATVIJAS PAGAIDU AIZSARDZIBA,0,0,0,0,0
KULDIGAS NOVADS,LATVIJAS NEPILSONIS,2,596,0,21,619
KULDIGAS NOVADS,LATVIJAS BEGLIS,0,0,0,0,0
KULDIGAS NOVADS,LATVIJAS BEZVALSTNIEKS,0,0,0,0,0
KULDIGAS NOVADS,LATVIJAS ALTERNATIVAIS,0,0,0,0,0
KULDIGAS NOVADS,PAREJIE,1,66,0,2,69
KEGUMA NOVADS,LATVIJAS PILSONIS,20,5599,2,82,5703
KEGUMA NOVADS,LATVIJAS PAGAIDU AIZSARDZIBA,0,0,0,0,0
KEGUMA NOVADS,LATVIJAS NEPILSONIS,2,365,0,25,392
KEGUMA NOVADS,LATVIJAS BEGLIS,0,0,0,0,0
KEGUMA NOVADS,LATVIJAS BEZVALSTNIEKS,0,0,0,0,0
KEGUMA NOVADS,LATVIJAS ALTERNATIVAIS,0,0,0,0,0
KEGUMA NOVADS,PAREJIE,1,50,0,0,51
KEKAVAS NOVADS,LATVIJAS PILSONIS,121,19919,5,286,20331
KEKAVAS NOVADS,LATVIJAS PAGAIDU AIZSARDZIBA,0,0,0,0,0
KEKAVAS NOVADS,LATVIJAS NEPILSONIS,11,1747,0,102,1860
KEKAVAS NOVADS,LATVIJAS BEGLIS,0,0,0,0,0
KEKAVAS NOVADS,LATVIJAS BEZVALSTNIEKS,0,1,0,0,1
KEKAVAS NOVADS,LATVIJAS ALTERNATIVAIS,0,0,0,0,0
KEKAVAS NOVADS,PAREJIE,15,364,0,10,389
LIELVARDES NOVADS,LATVIJAS PILSONIS,9,10207,0,155,10371
LIELVARDES NOVADS,LATVIJAS PAGAIDU AIZSARDZIBA,0,0,0,0,0
LIELVARDES NOVADS,LATVIJAS NEPILSONIS,4,538,0,42,584
LIELVARDES NOVADS,LATVIJAS BEGLIS,0,0,0,0,0
LIELVARDES NOVADS,LATVIJAS BEZVALSTNIEKS,0,0,0,0,0
LIELVARDES NOVADS,LATVIJAS ALTERNATIVAIS,0,0,0,0,0
LIELVARDES NOVADS,PAREJIE,4,92,0,1,97
LIMBAZU NOVADS,LATVIJAS PILSONIS,57,17801,3,145,18006
LIMBAZU NOVADS,LATVIJAS PAGAIDU AIZSARDZIBA,0,0,0,0,0
LIMBAZU NOVADS,LATVIJAS NEPILSONIS,3,625,0,27,655
LIMBAZU NOVADS,LATVIJAS BEGLIS,0,0,0,0,0
LIMBAZU NOVADS,LATVIJAS BEZVALSTNIEKS,0,1,0,0,1
LIMBAZU NOVADS,LATVIJAS ALTERNATIVAIS,0,1,0,0,1
LIMBAZU NOVADS,PAREJIE,5,62,0,2,69
LIGATNES NOVADS,LATVIJAS PILSONIS,3,3629,1,22,3655
LIGATNES NOVADS,LATVIJAS PAGAIDU AIZSARDZIBA,0,0,0,0,0
LIGATNES NOVADS,LATVIJAS NEPILSONIS,1,151,0,6,158
LIGATNES NOVADS,LATVIJAS BEGLIS,0,0,0,0,0
LIGATNES NOVADS,LATVIJAS BEZVALSTNIEKS,0,0,0,0,0
LIGATNES NOVADS,LATVIJAS ALTERNATIVAIS,0,0,0,0,0
LIGATNES NOVADS,PAREJIE,2,24,0,0,26
LIVANU NOVADS,LATVIJAS PILSONIS,42,12227,0,132,12401
LIVANU NOVADS,LATVIJAS PAGAIDU AIZSARDZIBA,0,0,0,0,0
LIVANU NOVADS,LATVIJAS NEPILSONIS,32,688,0,74,794
LIVANU NOVADS,LATVIJAS BEGLIS,0,0,0,0,0
LIVANU NOVADS,LATVIJAS BEZVALSTNIEKS,0,0,0,0,0
LIVANU NOVADS,LATVIJAS ALTERNATIVAIS,0,1,0,0,1
LIVANU NOVADS,PAREJIE,4,200,0,3,207
LUBANAS NOVADS,LATVIJAS PILSONIS,4,2707,0,5,2716
LUBANAS NOVADS,LATVIJAS PAGAIDU AIZSARDZIBA,0,0,0,0,0
LUBANAS NOVADS,LATVIJAS NEPILSONIS,0,29,0,0,29
LUBANAS NOVADS,LATVIJAS BEGLIS,0,0,0,0,0
LUBANAS NOVADS,LATVIJAS BEZVALSTNIEKS,0,0,0,0,0
LUBANAS NOVADS,LATVIJAS ALTERNATIVAIS,0,0,0,0,0
LUBANAS NOVADS,PAREJIE,0,7,0,0,7
LUDZAS NOVADS,LATVIJAS PILSONIS,23,13288,0,182,13493
LUDZAS NOVADS,LATVIJAS PAGAIDU AIZSARDZIBA,0,0,0,0,0
LUDZAS NOVADS,LATVIJAS NEPILSONIS,0,980,0,60,1040
LUDZAS NOVADS,LATVIJAS BEGLIS,0,0,0,0,0
LUDZAS NOVADS,LATVIJAS BEZVALSTNIEKS,0,0,0,0,0
LUDZAS NOVADS,LATVIJAS ALTERNATIVAIS,0,0,0,0,0
LUDZAS NOVADS,PAREJIE,1,201,0,0,202
MADONAS NOVADS,LATVIJAS PILSONIS,190,24998,2,263,25453
MADONAS NOVADS,LATVIJAS PAGAIDU AIZSARDZIBA,0,0,0,0,0
MADONAS NOVADS,LATVIJAS NEPILSONIS,14,1018,1,69,1102
MADONAS NOVADS,LATVIJAS BEGLIS,0,0,0,0,0
MADONAS NOVADS,LATVIJAS BEZVALSTNIEKS,0,0,0,0,0
MADONAS NOVADS,LATVIJAS ALTERNATIVAIS,0,0,0,0,0
MADONAS NOVADS,PAREJIE,8,132,1,2,143
MAZSALACAS NOVADS,LATVIJAS PILSONIS,11,3492,3,24,3530
MAZSALACAS NOVADS,LATVIJAS PAGAIDU AIZSARDZIBA,0,0,0,0,0
MAZSALACAS NOVADS,LATVIJAS NEPILSONIS,2,147,0,9,158
MAZSALACAS NOVADS,LATVIJAS BEGLIS,0,0,0,0,0
MAZSALACAS NOVADS,LATVIJAS BEZVALSTNIEKS,0,0,0,0,0
MAZSALACAS NOVADS,LATVIJAS ALTERNATIVAIS,0,0,0,0,0
MAZSALACAS NOVADS,PAREJIE,0,10,0,0,10
MALPILS NOVADS,LATVIJAS PILSONIS,16,3522,0,27,3565
MALPILS NOVADS,LATVIJAS PAGAIDU AIZSARDZIBA,0,0,0,0,0
MALPILS NOVADS,LATVIJAS NEPILSONIS,2,220,0,4,226
MALPILS NOVADS,LATVIJAS BEGLIS,0,0,0,0,0
MALPILS NOVADS,LATVIJAS BEZVALSTNIEKS,0,1,0,0,1
MALPILS NOVADS,LATVIJAS ALTERNATIVAIS,0,0,0,0,0
MALPILS NOVADS,PAREJIE,2,21,0,0,23
MARUPES NOVADS,LATVIJAS PILSONIS,23,14694,5,153,14875
MARUPES NOVADS,LATVIJAS PAGAIDU AIZSARDZIBA,0,0,0,0,0
MARUPES NOVADS,LATVIJAS NEPILSONIS,7,1301,0,53,1361
MARUPES NOVADS,LATVIJAS BEGLIS,0,0,0,0,0
MARUPES NOVADS,LATVIJAS BEZVALSTNIEKS,0,1,0,0,1
MARUPES NOVADS,LATVIJAS ALTERNATIVAIS,0,0,0,0,0
MARUPES NOVADS,PAREJIE,30,596,1,19,646
MERSRAGA NOVADS,LATVIJAS PILSONIS,13,1707,0,7,1727
MERSRAGA NOVADS,LATVIJAS PAGAIDU AIZSARDZIBA,0,0,0,0,0
MERSRAGA NOVADS,LATVIJAS NEPILSONIS,0,39,0,0,39
MERSRAGA NOVADS,LATVIJAS BEGLIS,0,0,0,0,0
MERSRAGA NOVADS,LATVIJAS BEZVALSTNIEKS,0,0,0,0,0
MERSRAGA NOVADS,LATVIJAS ALTERNATIVAIS,0,0,0,0,0
MERSRAGA NOVADS,PAREJIE,0,10,0,1,11
NAUKSENU NOVADS,LATVIJAS PILSONIS,5,2061,0,21,2087
NAUKSENU NOVADS,LATVIJAS PAGAIDU AIZSARDZIBA,0,0,0,0,0
NAUKSENU NOVADS,LATVIJAS NEPILSONIS,1,34,0,0,35
NAUKSENU NOVADS,LATVIJAS BEGLIS,0,0,0,0,0
NAUKSENU NOVADS,LATVIJAS BEZVALSTNIEKS,0,0,0,0,0
NAUKSENU NOVADS,LATVIJAS ALTERNATIVAIS,0,0,0,0,0
NAUKSENU NOVADS,PAREJIE,0,2,0,0,2
NERETAS NOVADS,LATVIJAS PILSONIS,8,3744,0,20,3772
NERETAS NOVADS,LATVIJAS PAGAIDU AIZSARDZIBA,0,0,0,0,0
NERETAS NOVADS,LATVIJAS NEPILSONIS,4,318,0,23,345
NERETAS NOVADS,LATVIJAS BEGLIS,0,0,0,0,0
NERETAS NOVADS,LATVIJAS BEZVALSTNIEKS,0,0,0,0,0
NERETAS NOVADS,LATVIJAS ALTERNATIVAIS,0,0,0,0,0
NERETAS NOVADS,PAREJIE,7,20,0,0,27
NICAS NOVADS,LATVIJAS PILSONIS,6,3587,1,20,3614
NICAS NOVADS,LATVIJAS PAGAIDU AIZSARDZIBA,0,0,0,0,0
NICAS NOVADS,LATVIJAS NEPILSONIS,0,66,0,3,69
NICAS NOVADS,LATVIJAS BEGLIS,0,0,0,0,0
NICAS NOVADS,LATVIJAS BEZVALSTNIEKS,0,0,0,0,0
NICAS NOVADS,LATVIJAS ALTERNATIVAIS,0,0,0,0,0
NICAS NOVADS,PAREJIE,1,30,0,0,31
OGRES NOVADS,LATVIJAS PILSONIS,103,33176,0,717,33996
OGRES NOVADS,LATVIJAS PAGAIDU AIZSARDZIBA,0,0,0,0,0
OGRES NOVADS,LATVIJAS NEPILSONIS,9,2939,0,250,3198
OGRES NOVADS,LATVIJAS BEGLIS,0,0,0,0,0
OGRES NOVADS,LATVIJAS BEZVALSTNIEKS,0,1,0,1,2
OGRES NOVADS,LATVIJAS ALTERNATIVAIS,0,0,0,0,0
OGRES NOVADS,PAREJIE,30,446,0,13,489
OLAINES NOVADS,LATVIJAS PILSONIS,35,14470,1,306,14812
OLAINES NOVADS,LATVIJAS PAGAIDU AIZSARDZIBA,0,0,0,0,0
OLAINES NOVADS,LATVIJAS NEPILSONIS,8,4710,0,243,4961
OLAINES NOVADS,LATVIJAS BEGLIS,0,0,0,0,0
OLAINES NOVADS,LATVIJAS BEZVALSTNIEKS,0,1,0,0,1
OLAINES NOVADS,LATVIJAS ALTERNATIVAIS,0,0,0,0,0
OLAINES NOVADS,PAREJIE,3,666,0,17,686
OZOLNIEKU NOVADS,LATVIJAS PILSONIS,29,8883,0,176,9088
OZOLNIEKU NOVADS,LATVIJAS PAGAIDU AIZSARDZIBA,0,0,0,0,0
OZOLNIEKU NOVADS,LATVIJAS NEPILSONIS,3,1037,0,107,1147
OZOLNIEKU NOVADS,LATVIJAS BEGLIS,0,0,0,0,0
OZOLNIEKU NOVADS,LATVIJAS BEZVALSTNIEKS,0,0,0,0,0
OZOLNIEKU NOVADS,LATVIJAS ALTERNATIVAIS,0,0,0,0,0
OZOLNIEKU NOVADS,PAREJIE,6,253,0,2,261
PARGAUJAS NOVADS,LATVIJAS PILSONIS,35,4122,0,18,4175
PARGAUJAS NOVADS,LATVIJAS PAGAIDU AIZSARDZIBA,0,0,0,0,0
PARGAUJAS NOVADS,LATVIJAS NEPILSONIS,2,102,0,7,111
PARGAUJAS NOVADS,LATVIJAS BEGLIS,0,0,0,0,0
PARGAUJAS NOVADS,LATVIJAS BEZVALSTNIEKS,0,1,0,0,1
PARGAUJAS NOVADS,LATVIJAS ALTERNATIVAIS,0,0,0,0,0
PARGAUJAS NOVADS,PAREJIE,0,6,0,0,6
PAVILOSTAS NOVADS,LATVIJAS PILSONIS,6,2938,0,13,2957
PAVILOSTAS NOVADS,LATVIJAS PAGAIDU AIZSARDZIBA,0,0,0,0,0
PAVILOSTAS NOVADS,LATVIJAS NEPILSONIS,1,104,0,2,107
PAVILOSTAS NOVADS,LATVIJAS BEGLIS,0,0,0,0,0
PAVILOSTAS NOVADS,LATVIJAS BEZVALSTNIEKS,0,0,0,0,0
PAVILOSTAS NOVADS,LATVIJAS ALTERNATIVAIS,0,0,0,0,0
PAVILOSTAS NOVADS,PAREJIE,0,13,0,0,13
PLAVINU NOVADS,LATVIJAS PILSONIS,8,5398,1,81,5488
PLAVINU NOVADS,LATVIJAS PAGAIDU AIZSARDZIBA,0,0,0,0,0
PLAVINU NOVADS,LATVIJAS NEPILSONIS,0,487,0,23,510
PLAVINU NOVADS,LATVIJAS BEGLIS,0,0,0,0,0
PLAVINU NOVADS,LATVIJAS BEZVALSTNIEKS,0,0,0,0,0
PLAVINU NOVADS,LATVIJAS ALTERNATIVAIS,0,0,0,0,0
PLAVINU NOVADS,PAREJIE,0,32,0,0,32
PREILU NOVADS,LATVIJAS PILSONIS,14,10444,0,146,10604
PREILU NOVADS,LATVIJAS PAGAIDU AIZSARDZIBA,0,0,0,0,0
PREILU NOVADS,LATVIJAS NEPILSONIS,3,331,0,41,375
PREILU NOVADS,LATVIJAS BEGLIS,0,0,0,0,0
PREILU NOVADS,LATVIJAS BEZVALSTNIEKS,0,1,0,0,1
PREILU NOVADS,LATVIJAS ALTERNATIVAIS,0,0,0,0,0
PREILU NOVADS,PAREJIE,2,74,0,0,76
PRIEKULES NOVADS,LATVIJAS PILSONIS,7,5643,0,43,5693
PRIEKULES NOVADS,LATVIJAS PAGAIDU AIZSARDZIBA,0,0,0,0,0
PRIEKULES NOVADS,LATVIJAS NEPILSONIS,4,514,0,13,531
PRIEKULES NOVADS,LATVIJAS BEGLIS,0,0,0,0,0
PRIEKULES NOVADS,LATVIJAS BEZVALSTNIEKS,0,1,0,0,1
PRIEKULES NOVADS,LATVIJAS ALTERNATIVAIS,0,0,0,0,0
PRIEKULES NOVADS,PAREJIE,4,55,0,1,60
PRIEKULU NOVADS,LATVIJAS PILSONIS,27,7992,1,110,8130
PRIEKULU NOVADS,LATVIJAS PAGAIDU AIZSARDZIBA,0,0,0,0,0
PRIEKULU NOVADS,LATVIJAS NEPILSONIS,1,691,0,30,722
PRIEKULU NOVADS,LATVIJAS BEGLIS,0,0,0,0,0
PRIEKULU NOVADS,LATVIJAS BEZVALSTNIEKS,0,0,0,0,0
PRIEKULU NOVADS,LATVIJAS ALTERNATIVAIS,0,0,0,0,0
PRIEKULU NOVADS,PAREJIE,0,78,0,0,78
RAUNAS NOVADS,LATVIJAS PILSONIS,50,3545,0,38,3633
RAUNAS NOVADS,LATVIJAS PAGAIDU AIZSARDZIBA,0,0,0,0,0
RAUNAS NOVADS,LATVIJAS NEPILSONIS,0,167,0,2,169
RAUNAS NOVADS,LATVIJAS BEGLIS,0,0,0,0,0
RAUNAS NOVADS,LATVIJAS BEZVALSTNIEKS,0,0,0,0,0
RAUNAS NOVADS,LATVIJAS ALTERNATIVAIS,0,0,0,0,0
RAUNAS NOVADS,PAREJIE,1,4,0,0,5
REZEKNES NOVADS,LATVIJAS PILSONIS,46,28838,4,214,29102
REZEKNES NOVADS,LATVIJAS PAGAIDU AIZSARDZIBA,0,0,0,0,0
REZEKNES NOVADS,LATVIJAS NEPILSONIS,2,1152,0,114,1268
REZEKNES NOVADS,LATVIJAS BEGLIS,0,0,0,0,0
REZEKNES NOVADS,LATVIJAS BEZVALSTNIEKS,0,1,0,0,1
REZEKNES NOVADS,LATVIJAS ALTERNATIVAIS,0,0,0,0,0
REZEKNES NOVADS,PAREJIE,4,219,0,1,224
RIEBINU NOVADS,LATVIJAS PILSONIS,95,5518,0,34,5647
RIEBINU NOVADS,LATVIJAS PAGAIDU AIZSARDZIBA,0,0,0,0,0
RIEBINU NOVADS,LATVIJAS NEPILSONIS,1,173,0,2,176
RIEBINU NOVADS,LATVIJAS BEGLIS,0,0,0,0,0
RIEBINU NOVADS,LATVIJAS BEZVALSTNIEKS,0,0,0,0,0
RIEBINU NOVADS,LATVIJAS ALTERNATIVAIS,0,0,0,0,0
RIEBINU NOVADS,PAREJIE,0,31,0,0,31
ROJAS NOVADS,LATVIJAS PILSONIS,13,4137,0,46,4196
ROJAS NOVADS,LATVIJAS PAGAIDU AIZSARDZIBA,0,0,0,0,0
ROJAS NOVADS,LATVIJAS NEPILSONIS,1,64,0,0,65
ROJAS NOVADS,LATVIJAS BEGLIS,0,0,0,0,0
ROJAS NOVADS,LATVIJAS BEZVALSTNIEKS,0,0,0,0,0
ROJAS NOVADS,LATVIJAS ALTERNATIVAIS,0,0,0,0,0
ROJAS NOVADS,PAREJIE,1,36,0,2,39
ROPAZU NOVADS,LATVIJAS PILSONIS,31,5961,1,131,6124
ROPAZU NOVADS,LATVIJAS PAGAIDU AIZSARDZIBA,0,0,0,0,0
ROPAZU NOVADS,LATVIJAS NEPILSONIS,3,744,0,50,797
ROPAZU NOVADS,LATVIJAS BEGLIS,13,0,0,0,13
ROPAZU NOVADS,LATVIJAS BEZVALSTNIEKS,0,1,0,0,1
ROPAZU NOVADS,LATVIJAS ALTERNATIVAIS,13,2,0,0,15
ROPAZU NOVADS,PAREJIE,12,114,0,5,131
RUCAVAS NOVADS,LATVIJAS PILSONIS,1,1829,1,3,1834
RUCAVAS NOVADS,LATVIJAS PAGAIDU AIZSARDZIBA,0,0,0,0,0
RUCAVAS NOVADS,LATVIJAS NEPILSONIS,1,61,0,3,65
RUCAVAS NOVADS,LATVIJAS BEGLIS,0,0,0,0,0
RUCAVAS NOVADS,LATVIJAS BEZVALSTNIEKS,0,0,0,0,0
RUCAVAS NOVADS,LATVIJAS ALTERNATIVAIS,0,0,0,0,0
RUCAVAS NOVADS,PAREJIE,1,16,0,0,17
RUGAJU NOVADS,LATVIJAS PILSONIS,8,2503,0,8,2519
RUGAJU NOVADS,LATVIJAS PAGAIDU AIZSARDZIBA,0,0,0,0,0
RUGAJU NOVADS,LATVIJAS NEPILSONIS,1,47,0,0,48
RUGAJU NOVADS,LATVIJAS BEGLIS,0,0,0,0,0
RUGAJU NOVADS,LATVIJAS BEZVALSTNIEKS,0,0,0,0,0
RUGAJU NOVADS,LATVIJAS ALTERNATIVAIS,0,0,0,0,0
RUGAJU NOVADS,PAREJIE,0,2,0,0,2
RUNDALES NOVADS,LATVIJAS PILSONIS,21,3388,0,45,3454
RUNDALES NOVADS,LATVIJAS PAGAIDU AIZSARDZIBA,0,0,0,0,0
RUNDALES NOVADS,LATVIJAS NEPILSONIS,1,607,0,15,623
RUNDALES NOVADS,LATVIJAS BEGLIS,0,0,0,0,0
RUNDALES NOVADS,LATVIJAS BEZVALSTNIEKS,0,0,0,0,0
RUNDALES NOVADS,LATVIJAS ALTERNATIVAIS,0,0,0,0,0
RUNDALES NOVADS,PAREJIE,2,21,0,1,24
RUJIENAS NOVADS,LATVIJAS PILSONIS,25,5597,0,22,5644
RUJIENAS NOVADS,LATVIJAS PAGAIDU AIZSARDZIBA,0,0,0,0,0
RUJIENAS NOVADS,LATVIJAS NEPILSONIS,0,181,0,3,184
RUJIENAS NOVADS,LATVIJAS BEGLIS,0,0,0,0,0
RUJIENAS NOVADS,LATVIJAS BEZVALSTNIEKS,0,0,0,0,0
RUJIENAS NOVADS,LATVIJAS ALTERNATIVAIS,0,1,0,0,1
RUJIENAS NOVADS,PAREJIE,0,12,0,0,12
SALACGRIVAS NOVADS,LATVIJAS PILSONIS,13,8517,4,38,8572
SALACGRIVAS NOVADS,LATVIJAS PAGAIDU AIZSARDZIBA,0,0,0,0,0
SALACGRIVAS NOVADS,LATVIJAS NEPILSONIS,0,286,0,12,298
SALACGRIVAS NOVADS,LATVIJAS BEGLIS,0,0,0,0,0
SALACGRIVAS NOVADS,LATVIJAS BEZVALSTNIEKS,0,0,0,0,0
SALACGRIVAS NOVADS,LATVIJAS ALTERNATIVAIS,0,0,0,0,0
SALACGRIVAS NOVADS,PAREJIE,3,45,0,0,48
SALAS NOVADS,LATVIJAS PILSONIS,18,3818,8,39,3883
SALAS NOVADS,LATVIJAS PAGAIDU AIZSARDZIBA,0,0,0,0,0
SALAS NOVADS,LATVIJAS NEPILSONIS,0,268,0,18,286
SALAS NOVADS,LATVIJAS BEGLIS,0,0,0,0,0
SALAS NOVADS,LATVIJAS BEZVALSTNIEKS,0,0,0,0,0
SALAS NOVADS,LATVIJAS ALTERNATIVAIS,0,0,0,0,0
SALAS NOVADS,PAREJIE,0,20,0,0,20
SALASPILS NOVADS,LATVIJAS PILSONIS,50,16900,1,266,17217
SALASPILS NOVADS,LATVIJAS PAGAIDU AIZSARDZIBA,0,0,0,0,0
SALASPILS NOVADS,LATVIJAS NEPILSONIS,6,5016,0,334,5356
SALASPILS NOVADS,LATVIJAS BEGLIS,0,0,0,0,0
SALASPILS NOVADS,LATVIJAS BEZVALSTNIEKS,0,1,0,0,1
SALASPILS NOVADS,LATVIJAS ALTERNATIVAIS,0,0,0,0,0
SALASPILS NOVADS,PAREJIE,10,720,0,10,740
SALDUS NOVADS,LATVIJAS PILSONIS,56,25729,2,361,26148
SALDUS NOVADS,LATVIJAS PAGAIDU AIZSARDZIBA,0,0,0,0,0
SALDUS NOVADS,LATVIJAS NEPILSONIS,4,1133,0,73,1210
SALDUS NOVADS,LATVIJAS BEGLIS,0,0,0,0,0
SALDUS NOVADS,LATVIJAS BEZVALSTNIEKS,0,0,0,0,0
SALDUS NOVADS,LATVIJAS ALTERNATIVAIS,0,0,0,0,0
SALDUS NOVADS,PAREJIE,10,180,0,6,196
SAULKRASTU NOVADS,LATVIJAS PILSONIS,34,5619,1,62,5716
SAULKRASTU NOVADS,LATVIJAS PAGAIDU AIZSARDZIBA,0,0,0,0,0
SAULKRASTU NOVADS,LATVIJAS NEPILSONIS,2,321,0,14,337
SAULKRASTU NOVADS,LATVIJAS BEGLIS,0,0,0,0,0
SAULKRASTU NOVADS,LATVIJAS BEZVALSTNIEKS,0,0,0,0,0
SAULKRASTU NOVADS,LATVIJAS ALTERNATIVAIS,0,0,0,0,0
SAULKRASTU NOVADS,PAREJIE,7,167,0,1,175
SEJAS NOVADS,LATVIJAS PILSONIS,14,2299,1,7,2321
SEJAS NOVADS,LATVIJAS PAGAIDU AIZSARDZIBA,0,0,0,0,0
SEJAS NOVADS,LATVIJAS NEPILSONIS,1,114,0,2,117
SEJAS NOVADS,LATVIJAS BEGLIS,0,0,0,0,0
SEJAS NOVADS,LATVIJAS BEZVALSTNIEKS,0,0,0,0,0
SEJAS NOVADS,LATVIJAS ALTERNATIVAIS,0,0,0,0,0
SEJAS NOVADS,PAREJIE,0,8,0,0,8
SIGULDAS NOVADS,LATVIJAS PILSONIS,40,17086,1,167,17294
SIGULDAS NOVADS,LATVIJAS PAGAIDU AIZSARDZIBA,0,0,0,0,0
SIGULDAS NOVADS,LATVIJAS NEPILSONIS,3,708,0,41,752
SIGULDAS NOVADS,LATVIJAS BEGLIS,0,0,0,0,0
SIGULDAS NOVADS,LATVIJAS BEZVALSTNIEKS,0,1,0,0,1
SIGULDAS NOVADS,LATVIJAS ALTERNATIVAIS,0,0,0,0,0
SIGULDAS NOVADS,PAREJIE,8,140,0,4,152
SKRIVERU NOVADS,LATVIJAS PILSONIS,3,3710,0,37,3750
SKRIVERU NOVADS,LATVIJAS PAGAIDU AIZSARDZIBA,0,0,0,0,0
SKRIVERU NOVADS,LATVIJAS NEPILSONIS,0,112,0,20,132
SKRIVERU NOVADS,LATVIJAS BEGLIS,0,0,0,0,0
SKRIVERU NOVADS,LATVIJAS BEZVALSTNIEKS,0,0,0,0,0
SKRIVERU NOVADS,LATVIJAS ALTERNATIVAIS,0,0,0,0,0
SKRIVERU NOVADS,PAREJIE,0,17,0,0,17
SKRUNDAS NOVADS,LATVIJAS PILSONIS,32,5377,0,25,5434
SKRUNDAS NOVADS,LATVIJAS PAGAIDU AIZSARDZIBA,0,0,0,0,0
SKRUNDAS NOVADS,LATVIJAS NEPILSONIS,2,228,0,7,237
SKRUNDAS NOVADS,LATVIJAS BEGLIS,0,0,0,0,0
SKRUNDAS NOVADS,LATVIJAS BEZVALSTNIEKS,0,0,0,0,0
SKRUNDAS NOVADS,LATVIJAS ALTERNATIVAIS,0,0,0,0,0
SKRUNDAS NOVADS,PAREJIE,1,44,0,1,46
SMILTENES NOVADS,LATVIJAS PILSONIS,33,13392,1,79,13505
SMILTENES NOVADS,LATVIJAS PAGAIDU AIZSARDZIBA,0,0,0,0,0
SMILTENES NOVADS,LATVIJAS NEPILSONIS,0,252,0,11,263
SMILTENES NOVADS,LATVIJAS BEGLIS,0,0,0,0,0
SMILTENES NOVADS,LATVIJAS BEZVALSTNIEKS,0,0,0,0,0
SMILTENES NOVADS,LATVIJAS ALTERNATIVAIS,0,0,0,0,0
SMILTENES NOVADS,PAREJIE,3,34,0,2,39
STOPINU NOVADS,LATVIJAS PILSONIS,24,8463,2,88,8577
STOPINU NOVADS,LATVIJAS PAGAIDU AIZSARDZIBA,0,0,0,0,0
STOPINU NOVADS,LATVIJAS NEPILSONIS,10,1492,0,72,1574
STOPINU NOVADS,LATVIJAS BEGLIS,0,1,0,0,1
STOPINU NOVADS,LATVIJAS BEZVALSTNIEKS,0,1,0,0,1
STOPINU NOVADS,LATVIJAS ALTERNATIVAIS,0,0,0,0,0
STOPINU NOVADS,PAREJIE,1,254,0,3,258
STRENCU NOVADS,LATVIJAS PILSONIS,19,3114,0,56,3189
STRENCU NOVADS,LATVIJAS PAGAIDU AIZSARDZIBA,0,0,0,0,0
STRENCU NOVADS,LATVIJAS NEPILSONIS,5,665,0,29,699
STRENCU NOVADS,LATVIJAS BEGLIS,0,0,0,0,0
STRENCU NOVADS,LATVIJAS BEZVALSTNIEKS,0,1,0,0,1
STRENCU NOVADS,LATVIJAS ALTERNATIVAIS,0,0,0,0,0
STRENCU NOVADS,PAREJIE,1,44,0,0,45
TALSU NOVADS,LATVIJAS PILSONIS,59,31757,4,462,32282
TALSU NOVADS,LATVIJAS PAGAIDU AIZSARDZIBA,0,0,0,0,0
TALSU NOVADS,LATVIJAS NEPILSONIS,3,706,0,32,741
TALSU NOVADS,LATVIJAS BEGLIS,0,0,0,0,0
TALSU NOVADS,LATVIJAS BEZVALSTNIEKS,0,6,0,0,6
TALSU NOVADS,LATVIJAS ALTERNATIVAIS,0,0,0,0,0
TALSU NOVADS,PAREJIE,6,82,0,1,89
TERVETES NOVADS,LATVIJAS PILSONIS,5,3441,0,21,3467
TERVETES NOVADS,LATVIJAS PAGAIDU AIZSARDZIBA,0,0,0,0,0
TERVETES NOVADS,LATVIJAS NEPILSONIS,0,371,0,10,381
TERVETES NOVADS,LATVIJAS BEGLIS,0,0,0,0,0
TERVETES NOVADS,LATVIJAS BEZVALSTNIEKS,0,0,0,0,0
TERVETES NOVADS,LATVIJAS ALTERNATIVAIS,0,0,0,0,0
TERVETES NOVADS,PAREJIE,0,20,0,0,20
TUKUMA NOVADS,LATVIJAS PILSONIS,103,29190,52,614,29959
TUKUMA NOVADS,LATVIJAS PAGAIDU AIZSARDZIBA,0,0,0,0,0
TUKUMA NOVADS,LATVIJAS NEPILSONIS,7,1759,6,132,1904
TUKUMA NOVADS,LATVIJAS BEGLIS,0,0,0,0,0
TUKUMA NOVADS,LATVIJAS BEZVALSTNIEKS,0,7,0,0,7
TUKUMA NOVADS,LATVIJAS ALTERNATIVAIS,0,0,0,0,0
TUKUMA NOVADS,PAREJIE,23,302,0,2,327
VAINODES NOVADS,LATVIJAS PILSONIS,2,2526,0,10,2538
VAINODES NOVADS,LATVIJAS PAGAIDU AIZSARDZIBA,0,0,0,0,0
VAINODES NOVADS,LATVIJAS NEPILSONIS,0,229,0,2,231
VAINODES NOVADS,LATVIJAS BEGLIS,0,0,0,0,0
VAINODES NOVADS,LATVIJAS BEZVALSTNIEKS,0,0,0,0,0
VAINODES NOVADS,LATVIJAS ALTERNATIVAIS,0,0,0,0,0
VAINODES NOVADS,PAREJIE,0,32,0,1,33
VALKAS NOVADS,LATVIJAS PILSONIS,19,8787,0,96,8902
VALKAS NOVADS,LATVIJAS PAGAIDU AIZSARDZIBA,0,0,0,0,0
VALKAS NOVADS,LATVIJAS NEPILSONIS,1,845,1,70,917
VALKAS NOVADS,LATVIJAS BEGLIS,0,0,0,0,0
VALKAS NOVADS,LATVIJAS BEZVALSTNIEKS,0,0,0,0,0
VALKAS NOVADS,LATVIJAS ALTERNATIVAIS,0,0,0,0,0
VALKAS NOVADS,PAREJIE,0,167,1,5,173
VARAKLANU NOVADS,LATVIJAS PILSONIS,15,3578,1,19,3613
VARAKLANU NOVADS,LATVIJAS PAGAIDU AIZSARDZIBA,0,0,0,0,0
VARAKLANU NOVADS,LATVIJAS NEPILSONIS,1,89,0,0,90
VARAKLANU NOVADS,LATVIJAS BEGLIS,0,0,0,0,0
VARAKLANU NOVADS,LATVIJAS BEZVALSTNIEKS,0,0,0,0,0
VARAKLANU NOVADS,LATVIJAS ALTERNATIVAIS,0,0,0,0,0
VARAKLANU NOVADS,PAREJIE,1,18,0,0,19
VARKAVAS NOVADS,LATVIJAS PILSONIS,35,2172,0,1,2208
VARKAVAS NOVADS,LATVIJAS PAGAIDU AIZSARDZIBA,0,0,0,0,0
VARKAVAS NOVADS,LATVIJAS NEPILSONIS,1,36,0,0,37
VARKAVAS NOVADS,LATVIJAS BEGLIS,0,0,0,0,0
VARKAVAS NOVADS,LATVIJAS BEZVALSTNIEKS,0,0,0,0,0
VARKAVAS NOVADS,LATVIJAS ALTERNATIVAIS,0,0,0,0,0
VARKAVAS NOVADS,PAREJIE,0,4,0,0,4
VECPIEBALGAS NOVADS,LATVIJAS PILSONIS,53,4285,1,24,4363
VECPIEBALGAS NOVADS,LATVIJAS PAGAIDU AIZSARDZIBA,0,0,0,0,0
VECPIEBALGAS NOVADS,LATVIJAS NEPILSONIS,0,114,0,11,125
VECPIEBALGAS NOVADS,LATVIJAS BEGLIS,0,0,0,0,0
VECPIEBALGAS NOVADS,LATVIJAS BEZVALSTNIEKS,0,0,0,0,0
VECPIEBALGAS NOVADS,LATVIJAS ALTERNATIVAIS,0,0,0,0,0
VECPIEBALGAS NOVADS,PAREJIE,0,8,0,0,8
VECUMNIEKU NOVADS,LATVIJAS PILSONIS,12,8495,1,69,8577
VECUMNIEKU NOVADS,LATVIJAS PAGAIDU AIZSARDZIBA,0,0,0,0,0
VECUMNIEKU NOVADS,LATVIJAS NEPILSONIS,3,616,1,30,650
VECUMNIEKU NOVADS,LATVIJAS BEGLIS,0,0,0,0,0
VECUMNIEKU NOVADS,LATVIJAS BEZVALSTNIEKS,0,1,0,0,1
VECUMNIEKU NOVADS,LATVIJAS ALTERNATIVAIS,0,0,0,0,0
VECUMNIEKU NOVADS,PAREJIE,8,68,0,0,76
VENTSPILS NOVADS,LATVIJAS PILSONIS,40,12328,4,102,12474
VENTSPILS NOVADS,LATVIJAS PAGAIDU AIZSARDZIBA,0,0,0,0,0
VENTSPILS NOVADS,LATVIJAS NEPILSONIS,3,471,0,28,502
VENTSPILS NOVADS,LATVIJAS BEGLIS,0,0,0,0,0
VENTSPILS NOVADS,LATVIJAS BEZVALSTNIEKS,0,0,0,0,0
VENTSPILS NOVADS,LATVIJAS ALTERNATIVAIS,0,0,0,0,0
VENTSPILS NOVADS,PAREJIE,5,92,0,2,99
VIESITES NOVADS,LATVIJAS PILSONIS,10,4013,1,28,4052
VIESITES NOVADS,LATVIJAS PAGAIDU AIZSARDZIBA,0,0,0,0,0
VIESITES NOVADS,LATVIJAS NEPILSONIS,0,280,0,4,284
VIESITES NOVADS,LATVIJAS BEGLIS,0,0,0,0,0
VIESITES NOVADS,LATVIJAS BEZVALSTNIEKS,0,0,0,0,0
VIESITES NOVADS,LATVIJAS ALTERNATIVAIS,0,0,0,0,0
VIESITES NOVADS,PAREJIE,0,9,0,0,9
VILAKAS NOVADS,LATVIJAS PILSONIS,18,5624,1,28,5671
VILAKAS NOVADS,LATVIJAS PAGAIDU AIZSARDZIBA,0,0,0,0,0
VILAKAS NOVADS,LATVIJAS NEPILSONIS,2,269,0,13,284
VILAKAS NOVADS,LATVIJAS BEGLIS,0,0,0,0,0
VILAKAS NOVADS,LATVIJAS BEZVALSTNIEKS,0,0,0,0,0
VILAKAS NOVADS,LATVIJAS ALTERNATIVAIS,0,0,0,0,0
VILAKAS NOVADS,PAREJIE,0,30,0,0,30
VILANU NOVADS,LATVIJAS PILSONIS,6,6433,0,40,6479
VILANU NOVADS,LATVIJAS PAGAIDU AIZSARDZIBA,0,0,0,0,0
VILANU NOVADS,LATVIJAS NEPILSONIS,0,230,0,9,239
VILANU NOVADS,LATVIJAS BEGLIS,0,0,0,0,0
VILANU NOVADS,LATVIJAS BEZVALSTNIEKS,0,0,0,0,0
VILANU NOVADS,LATVIJAS ALTERNATIVAIS,0,0,0,0,0
VILANU NOVADS,PAREJIE,0,37,0,0,37
ZILUPES NOVADS,LATVIJAS PILSONIS,34,3044,0,17,3095
ZILUPES NOVADS,LATVIJAS PAGAIDU AIZSARDZIBA,0,0,0,0,0
ZILUPES NOVADS,LATVIJAS NEPILSONIS,0,326,0,13,339
ZILUPES NOVADS,LATVIJAS BEGLIS,0,0,0,0,0
ZILUPES NOVADS,LATVIJAS BEZVALSTNIEKS,0,0,0,0,0
ZILUPES NOVADS,LATVIJAS ALTERNATIVAIS,0,0,0,0,0
ZILUPES NOVADS,PAREJIE,1,53,0,0,54